entry_date,entry_price,exit_date,exit_price,PnL,Balance,Cum_PnL
2021-01-01 07:00:00,28949.15,2021-01-01 09:45:00,29229.6,-280.45,99719.55,-280.45
2021-01-01 10:00:00,29306.43,2021-01-01 15:15:00,29318.62,12.19,99731.74,-268.26
2021-01-01 15:30:00,29149.98,2021-01-01 19:45:00,29048.47,101.51,99833.25,-166.75
2021-01-01 20:00:00,29183.83,2021-01-02 15:30:00,31635.92,2452.09,102285.34,2285.34
2021-01-02 20:30:00,32180.51,2021-01-02 22:00:00,31701.09,479.42,102764.76,2764.76
2021-01-02 22:15:00,32231.0,2021-01-03 14:45:00,33903.75,1672.75,104437.51,4437.51
2021-01-03 15:00:00,33450.17,2021-01-03 20:00:00,33361.96,88.21,104525.72,4525.72
2021-01-03 20:15:00,33742.0,2021-01-04 00:15:00,32850.51,-891.49,103634.23,3634.2300000000005
2021-01-04 00:30:00,32705.98,2021-01-04 02:30:00,33193.34,-487.36,103146.87,3146.8700000000003
2021-01-04 02:45:00,33502.99,2021-01-04 07:00:00,32905.4,-597.59,102549.28,2549.28
2021-01-04 07:15:00,32433.0,2021-01-04 10:30:00,29774.67,2658.33,105207.61,5207.610000000001
2021-01-04 10:45:00,30279.53,2021-01-04 21:15:00,31125.26,845.73,106053.34,6053.34
2021-01-04 21:30:00,30934.57,2021-01-04 23:30:00,31932.22,-1042.82,105010.52,5010.52
2021-01-04 23:45:00,32031.07,2021-01-05 03:15:00,31928.0,-103.07,104907.45,4907.450000000001
2021-01-05 03:30:00,31774.43,2021-01-05 07:45:00,30844.23,930.2,105837.65,5837.650000000001
2021-01-05 08:00:00,31398.04,2021-01-06 04:00:00,34531.52,3133.48,108971.13,8971.130000000001
2021-01-06 08:15:00,34240.88,2021-01-06 10:45:00,34462.55,-221.67,108749.46,8749.460000000001
2021-01-06 11:00:00,35041.67,2021-01-06 19:45:00,34861.7,-179.97,108569.49,8569.490000000002
2021-01-06 20:00:00,34365.96,2021-01-06 20:30:00,35420.8,-1054.84,107514.65,7514.6500000000015
2021-01-06 20:45:00,36131.01,2021-01-07 16:00:00,39598.42,3467.41,110982.06,10982.060000000001
2021-01-07 18:30:00,38032.38,2021-01-07 19:15:00,38799.9,-767.52,110214.54000000001,10214.54
2021-01-07 19:30:00,39233.42,2021-01-08 01:15:00,38578.62,-654.8,109559.74,9559.740000000002
2021-01-08 01:30:00,38275.3,2021-01-08 04:00:00,38593.87,-318.57,109241.17,9241.170000000002
2021-01-08 04:15:00,38736.06,2021-01-08 18:00:00,40763.21,2027.15,111268.32,11268.320000000002
2021-01-08 18:15:00,40301.92,2021-01-08 22:15:00,40150.12,151.8,111420.12,11420.12
2021-01-08 22:30:00,40628.82,2021-01-09 05:00:00,40006.51,-622.31,110797.81,10797.810000000001
2021-01-09 05:15:00,39763.67,2021-01-09 08:30:00,40076.07,-312.4,110485.41,10485.410000000002
2021-01-09 08:45:00,40210.89,2021-01-09 16:00:00,40471.01,260.12,110745.53,10745.530000000002
2021-01-09 16:15:00,40230.0,2021-01-09 18:45:00,40737.87,-507.87,110237.66,10237.660000000002
2021-01-09 19:00:00,40861.97,2021-01-09 23:00:00,40161.42,-926.27,109311.39,9311.390000000001
2021-01-10 03:45:00,40393.5,2021-01-10 06:15:00,40719.63,-326.13,108985.26000000001,8985.260000000002
2021-01-10 06:30:00,41011.01,2021-01-10 10:30:00,40491.0,-910.12,108075.14,8075.140000000002
2021-01-10 11:00:00,40202.13,2021-01-10 12:45:00,39562.7,639.43,108714.57,8714.570000000002
2021-01-10 13:00:00,39878.92,2021-01-10 17:00:00,39060.09,-818.83,107895.74,7895.740000000002
2021-01-10 17:15:00,38210.45,2021-01-10 20:30:00,37446.55,763.9,108659.64,8659.640000000001
2021-01-10 20:45:00,37782.81,2021-01-11 01:15:00,37756.14,-26.67,108632.97,8632.970000000001
2021-01-11 01:30:00,37219.22,2021-01-11 08:15:00,35300.71,1918.51,110551.48,10551.480000000001
2021-01-11 08:30:00,35805.39,2021-01-11 11:45:00,34218.66,-1586.73,108964.75,8964.750000000002
2021-01-11 12:00:00,33722.58,2021-01-11 20:30:00,32264.06,1458.52,110423.27,10423.270000000002
2021-01-11 20:45:00,33494.81,2021-01-12 10:00:00,35380.18,1885.37,112308.64,12308.640000000003
2021-01-12 10:15:00,34921.65,2021-01-12 15:45:00,33861.95,1059.7,113368.34,13368.340000000004
2021-01-12 16:00:00,34440.0,2021-01-12 20:15:00,34254.99,-185.01,113183.33,13183.330000000004
2021-01-12 20:30:00,33989.21,2021-01-13 06:15:00,33847.45,141.76,113325.09,13325.090000000004
2021-01-13 06:30:00,34000.0,2021-01-13 22:00:00,37819.58,3819.58,117144.67000000001,17144.670000000006
2021-01-14 03:45:00,37103.0,2021-01-14 06:00:00,37756.03,-653.03,116491.64000000001,16491.640000000007
2021-01-14 06:15:00,38055.37,2021-01-14 20:45:00,39347.95,1292.58,117784.22,17784.22000000001
2021-01-14 21:00:00,39054.55,2021-01-15 00:15:00,39430.01,-375.46,117408.76000000001,17408.76000000001
2021-01-15 00:30:00,39541.98,2021-01-15 03:15:00,38829.3,-712.68,116696.08000000002,16696.08000000001
2021-01-15 03:30:00,38705.0,2021-01-15 09:15:00,38489.65,215.35,116911.43000000001,16911.430000000008
2021-01-15 09:30:00,38693.61,2021-01-15 12:00:00,38115.01,-578.6,116332.83,16332.830000000007
2021-01-15 12:15:00,37475.55,2021-01-15 16:15:00,36030.0,1445.55,117778.38,17778.38000000001
2021-01-15 16:30:00,36186.5,2021-01-16 02:30:00,36536.0,349.5,118127.88,18127.88000000001
2021-01-16 02:45:00,36270.22,2021-01-16 06:45:00,36146.41,123.81,118251.69,18251.69000000001
2021-01-16 07:00:00,36788.57,2021-01-16 14:00:00,37295.08,506.51,118758.20000000001,18758.200000000008
2021-01-16 14:15:00,36757.87,2021-01-17 00:30:00,36222.0,535.87,119294.07,19294.070000000007
2021-01-17 00:45:00,36421.98,2021-01-17 04:30:00,36111.97,-310.01,118984.06000000001,18984.06000000001
2021-01-17 04:45:00,35890.01,2021-01-17 11:15:00,34918.84,971.17,119955.23000000001,19955.230000000007
2021-01-17 11:30:00,35282.57,2021-01-17 23:30:00,36216.1,933.53,120888.76000000001,20888.760000000006
2021-01-17 23:45:00,35869.83,2021-01-18 06:45:00,35223.0,646.83,121535.59000000001,21535.590000000007
2021-01-18 07:00:00,35941.92,2021-01-18 14:15:00,36865.96,924.04,122459.63,22459.63000000001
2021-01-18 14:30:00,36442.05,2021-01-18 21:15:00,36189.99,252.06,122711.69,22711.69000000001
2021-01-18 21:30:00,36212.85,2021-01-19 03:30:00,36748.36,535.51,123247.20000000001,23247.200000000008
2021-01-19 03:45:00,36555.99,2021-01-19 07:30:00,36732.45,-176.46,123070.74,23070.74000000001
2021-01-19 07:45:00,37225.61,2021-01-19 17:45:00,37226.44,0.83,123071.57,23071.57000000001
2021-01-19 18:00:00,36980.0,2021-01-20 07:00:00,35575.0,1405.0,124476.57,24476.57000000001
2021-01-20 07:15:00,35796.41,2021-01-20 09:15:00,35330.27,-466.14,124010.43000000001,24010.43000000001
2021-01-20 09:30:00,34854.93,2021-01-20 14:00:00,34921.31,-66.38,123944.05000000002,23944.05000000001
2021-01-20 14:15:00,35123.55,2021-01-20 16:00:00,34223.07,-1134.01,122810.04000000001,22810.04000000001
2021-01-21 01:30:00,34807.78,2021-01-21 07:00:00,34724.99,82.79,122892.83000000002,22892.830000000013
2021-01-21 07:15:00,34936.81,2021-01-21 08:15:00,34320.02,-616.79,122276.04000000001,22276.04000000001
2021-01-21 08:30:00,33786.45,2021-01-21 19:15:00,32585.16,1201.29,123477.33000000002,23477.330000000013
2021-01-21 19:30:00,32628.54,2021-01-21 21:30:00,31776.89,-851.65,122625.68000000001,22625.68000000001
2021-01-21 21:45:00,31245.4,2021-01-22 02:30:00,30550.9,694.5,123320.18000000001,23320.18000000001
2021-01-22 02:45:00,30702.96,2021-01-22 20:00:00,33712.66,3009.7,126329.88,26329.880000000012
2021-01-22 22:45:00,32885.52,2021-01-23 05:30:00,32955.59,-70.07,126259.81000000001,26259.810000000012
2021-01-23 05:45:00,33374.22,2021-01-23 09:30:00,32630.2,-744.02,125515.79000000001,25515.79000000001
2021-01-23 09:45:00,32469.02,2021-01-23 17:15:00,32116.28,352.74,125868.53000000001,25868.530000000013
2021-01-23 17:30:00,32317.45,2021-01-24 00:30:00,31976.01,-341.44,125527.09000000001,25527.090000000015
2021-01-24 00:45:00,31895.51,2021-01-24 03:30:00,32275.88,-380.37,125146.72000000002,25146.720000000016
2021-01-24 03:45:00,32494.03,2021-01-24 10:00:00,32655.88,161.85,125308.57,25308.570000000014
2021-01-24 10:15:00,32573.39,2021-01-24 20:15:00,31433.14,1140.25,126448.82,26448.820000000014
2021-01-24 20:30:00,31665.52,2021-01-25 09:15:00,33325.0,1659.48,128108.30000000002,28108.300000000014
2021-01-25 09:30:00,33091.21,2021-01-25 12:00:00,33420.29,-329.08,127779.22000000002,27779.220000000012
2021-01-25 12:15:00,33593.5,2021-01-25 16:00:00,34169.8,576.3,128355.52000000002,28355.52000000001
2021-01-25 16:15:00,33907.64,2021-01-26 01:30:00,32732.05,1175.59,129531.11000000002,29531.11000000001
2021-01-26 01:45:00,32763.5,2021-01-26 03:00:00,32266.76,-496.74,129034.37000000001,29034.37000000001
2021-01-26 03:15:00,31869.15,2021-01-26 09:45:00,31813.46,55.69,129090.06000000001,29090.06000000001
2021-01-26 10:00:00,32086.43,2021-01-26 12:30:00,31631.08,-455.35,128634.71,28634.71000000001
2021-01-26 12:45:00,31314.5,2021-01-26 16:15:00,31592.5,-278.0,128356.71,28356.71000000001
2021-01-26 16:30:00,31960.02,2021-01-27 00:15:00,32313.18,353.16,128709.87000000001,28709.87000000001
2021-01-27 00:30:00,32090.0,2021-01-27 10:45:00,31375.28,714.72,129424.59000000001,29424.59000000001
2021-01-27 11:00:00,31551.2,2021-01-27 11:30:00,31177.51,-373.69,129050.90000000001,29050.900000000012
2021-01-27 11:45:00,30647.15,2021-01-27 15:45:00,30318.63,328.52,129379.42000000001,29379.420000000013
2021-01-27 16:00:00,30756.53,2021-01-27 18:15:00,30092.53,-664.0,128715.42000000001,28715.420000000013
2021-01-27 18:30:00,29688.08,2021-01-27 19:45:00,30736.5,-1048.42,127667.00000000001,27667.000000000015
2021-01-27 20:00:00,30886.1,2021-01-27 22:45:00,30528.49,-357.61,127309.39000000001,27309.390000000014
2021-01-27 23:00:00,30298.13,2021-01-28 01:45:00,30879.55,-581.42,126727.97000000002,26727.970000000016
2021-01-28 02:00:00,31042.03,2021-01-28 08:00:00,31271.76,229.73,126957.70000000001,26957.700000000015
2021-01-28 08:15:00,31053.6,2021-01-28 13:30:00,31606.92,-553.32,126404.38000000002,26404.380000000016
2021-01-28 13:45:00,31796.39,2021-01-29 03:45:00,33756.0,1959.61,128363.99000000002,28363.990000000016
2021-01-29 04:00:00,33349.37,2021-01-29 08:15:00,32055.76,1293.61,129657.60000000002,29657.600000000017
2021-01-29 08:30:00,33362.82,2021-01-29 08:30:00,33362.82,-1205.33,128452.27000000002,28452.27000000002
2021-01-29 16:30:00,36678.25,2021-01-30 07:45:00,34073.81,2604.44,131056.71000000002,31056.710000000017
2021-01-30 08:00:00,34288.19,2021-01-30 16:00:00,33799.62,-488.57,130568.14000000001,30568.140000000018
2021-01-30 16:15:00,33592.56,2021-01-30 18:30:00,34211.99,-619.43,129948.71000000002,29948.710000000017
2021-01-30 18:45:00,34381.32,2021-01-31 00:00:00,34251.52,-129.8,129818.91000000002,29818.910000000018
2021-01-31 00:15:00,34144.38,2021-01-31 12:00:00,33450.84,693.54,130512.45000000001,30512.45000000002
2021-01-31 12:15:00,33987.38,2021-01-31 14:00:00,33627.39,-359.99,130152.46000000002,30152.460000000017
2021-01-31 14:15:00,33594.81,2021-01-31 22:00:00,32727.12,867.69,131020.15000000002,31020.150000000016
2021-01-31 22:15:00,32919.55,2021-02-01 00:00:00,32634.25,-285.3,130734.85000000002,30734.850000000017
2021-02-01 00:15:00,32443.49,2021-02-01 01:15:00,32942.96,-499.47,130235.38000000002,30235.380000000016
2021-02-01 01:30:00,33497.98,2021-02-01 06:30:00,33855.87,357.89,130593.27000000002,30593.270000000015
2021-02-01 06:45:00,33541.34,2021-02-01 08:30:00,33912.34,-371.0,130222.27000000002,30222.270000000015
2021-02-01 08:45:00,34511.89,2021-02-01 12:30:00,33964.68,-547.21,129675.06000000001,29675.060000000016
2021-02-01 12:45:00,33816.0,2021-02-01 17:30:00,33640.52,175.48,129850.54000000001,29850.540000000015
2021-02-01 17:45:00,33999.29,2021-02-01 23:15:00,33689.42,-309.87,129540.67000000001,29540.670000000016
2021-02-01 23:30:00,33474.01,2021-02-02 00:15:00,34028.23,-667.27,128873.40000000002,28873.400000000016
2021-02-02 05:30:00,33974.99,2021-02-02 11:30:00,35010.74,1035.75,129909.15000000002,29909.150000000016
2021-02-02 11:45:00,34821.61,2021-02-02 18:15:00,34903.18,-81.57,129827.58000000002,29827.580000000016
2021-02-02 18:30:00,35056.79,2021-02-03 07:45:00,36358.28,1301.49,131129.07,31129.070000000018
2021-02-03 08:00:00,36001.91,2021-02-03 11:45:00,36024.06,-22.15,131106.92,31106.920000000016
2021-02-03 12:00:00,36367.33,2021-02-04 08:30:00,38371.01,2003.68,133110.6,33110.60000000001
2021-02-04 08:45:00,37435.2,2021-02-04 18:00:00,37003.3,431.9,133542.5,33542.500000000015
2021-02-04 18:15:00,37422.22,2021-02-04 23:30:00,37101.64,-320.58,133221.92,33221.92000000001
2021-02-04 23:45:00,36976.93,2021-02-05 03:15:00,37280.4,-303.47,132918.45,32918.45000000001
2021-02-05 03:30:00,37393.07,2021-02-05 18:15:00,37767.38,374.31,133292.76,33292.76000000001
2021-02-05 18:30:00,37655.44,2021-02-05 21:30:00,37830.38,-174.94,133117.82,33117.82000000001
2021-02-05 21:45:00,37851.92,2021-02-06 11:15:00,40397.16,2545.24,135663.06,35663.060000000005
2021-02-06 19:30:00,40153.42,2021-02-06 21:45:00,40113.35,40.07,135703.13,35703.130000000005
2021-02-06 22:00:00,40451.51,2021-02-06 22:45:00,40094.85,-356.66,135346.47,35346.47
2021-02-06 23:00:00,39459.6,2021-02-07 00:30:00,39541.45,-81.85,135264.62,35264.62
2021-02-07 00:45:00,39621.67,2021-02-07 01:45:00,38674.27,-1026.52,134238.1,34238.100000000006
2021-02-07 04:15:00,38500.0,2021-02-07 06:45:00,38569.29,-69.29,134168.81,34168.810000000005
2021-02-07 07:00:00,38974.0,2021-02-07 12:00:00,39189.6,215.6,134384.41,34384.41
2021-02-07 12:15:00,38723.02,2021-02-07 18:45:00,38285.02,438.0,134822.41,34822.41
2021-02-07 19:00:00,38384.42,2021-02-08 02:30:00,38476.01,91.59,134914.0,34914.0
2021-02-08 02:45:00,38308.39,2021-02-08 05:15:00,38688.25,-379.86,134534.14,34534.14
2021-02-08 05:30:00,38857.26,2021-02-08 12:45:00,43543.1,4685.84,139219.97999999998,39219.979999999996
2021-02-08 17:00:00,42854.66,2021-02-08 21:00:00,44061.4,-1206.74,138013.24,38013.24
2021-02-08 21:15:00,44471.93,2021-02-09 09:15:00,46922.13,2450.2,140463.44,40463.439999999995
2021-02-09 09:30:00,46168.9,2021-02-09 15:00:00,46534.92,-366.02,140097.41999999998,40097.42
2021-02-09 15:15:00,47120.47,2021-02-10 00:45:00,46612.92,-507.55,139589.87,39589.869999999995
2021-02-10 01:00:00,46387.1,2021-02-10 07:15:00,46663.81,-276.71,139313.16,39313.159999999996
2021-02-10 07:30:00,47063.69,2021-02-10 11:45:00,46685.0,-378.69,138934.47,38934.469999999994
2021-02-10 12:00:00,46313.45,2021-02-10 18:30:00,44962.75,1350.7,140285.16999999998,40285.16999999999
2021-02-10 18:45:00,45145.04,2021-02-11 00:45:00,44301.01,-844.03,139441.13999999998,39441.13999999999
2021-02-11 01:00:00,44277.03,2021-02-11 03:30:00,44811.17,-534.14,138907.0,38906.99999999999
2021-02-11 03:45:00,45518.84,2021-02-11 05:00:00,44733.34,-785.5,138121.5,38121.49999999999
2021-02-11 05:15:00,44655.41,2021-02-11 09:30:00,45176.55,-521.14,137600.36,37600.35999999999
2021-02-11 09:45:00,45550.41,2021-02-11 16:45:00,47699.1,2148.69,139749.05,39749.049999999996
2021-02-11 17:00:00,47173.21,2021-02-11 20:00:00,48012.33,-839.12,138909.93,38909.92999999999
2021-02-11 20:15:00,48700.0,2021-02-11 20:30:00,48485.95,-214.05,138695.88,38695.87999999999
2021-02-11 20:45:00,47105.58,2021-02-11 23:15:00,47783.65,-678.07,138017.81,38017.80999999999
2021-02-11 23:30:00,47889.93,2021-02-12 02:45:00,48047.39,157.46,138175.27,38175.26999999999
2021-02-12 03:00:00,47969.09,2021-02-12 11:00:00,47497.99,471.1,138646.37,38646.36999999999
2021-02-12 11:15:00,47967.34,2021-02-12 14:15:00,47481.21,-486.13,138160.24,38160.23999999999
2021-02-12 14:30:00,46723.47,2021-02-12 15:45:00,47083.34,-359.87,137800.37,37800.36999999999
2021-02-12 16:00:00,47326.35,2021-02-13 05:00:00,47846.39,520.04,138320.40999999997,38320.40999999999
2021-02-13 05:15:00,47544.05,2021-02-13 15:45:00,47127.31,416.74,138737.15,38737.14999999999
2021-02-13 16:00:00,47242.08,2021-02-14 14:30:00,49011.02,1768.94,140506.09,40506.08999999999
2021-02-14 14:45:00,48851.17,2021-02-14 21:00:00,48952.39,-101.22,140404.87,40404.86999999999
2021-02-14 21:15:00,49055.53,2021-02-15 00:45:00,48847.2,-208.33,140196.53999999998,40196.539999999986
2021-02-15 01:00:00,48518.22,2021-02-15 02:15:00,46400.22,2118.0,142314.53999999998,42314.539999999986
2021-02-15 02:30:00,46883.96,2021-02-15 22:00:00,48224.42,1340.46,143655.0,43654.999999999985
2021-02-15 22:15:00,47955.71,2021-02-16 01:00:00,47745.0,210.71,143865.71,43865.709999999985
2021-02-16 01:15:00,48250.1,2021-02-16 06:00:00,49260.0,1009.9,144875.61,44875.609999999986
2021-02-16 06:15:00,48849.99,2021-02-16 12:00:00,49468.21,-618.22,144257.38999999998,44257.389999999985
2021-02-16 12:15:00,50067.42,2021-02-16 13:30:00,49216.6,-850.82,143406.56999999998,43406.569999999985
2021-02-16 13:45:00,49052.3,2021-02-16 22:15:00,48639.76,412.54,143819.11,43819.109999999986
2021-02-16 22:30:00,48948.52,2021-02-17 04:15:00,49490.49,541.97,144361.08,44361.07999999999
2021-02-17 04:30:00,49178.72,2021-02-17 06:00:00,50001.01,-995.61,143365.46999999997,43365.46999999999
2021-02-17 06:45:00,50627.99,2021-02-18 03:45:00,52131.96,1503.97,144869.44,44869.43999999999
2021-02-18 04:00:00,51997.38,2021-02-18 13:30:00,51859.99,137.39,145006.83,45006.82999999999
2021-02-18 13:45:00,51884.3,2021-02-18 23:30:00,51631.11,-253.19,144753.63999999998,44753.639999999985
2021-02-18 23:45:00,51619.7,2021-02-19 05:45:00,51579.63,40.07,144793.71,44793.709999999985
2021-02-19 06:00:00,51700.04,2021-02-19 18:30:00,55118.27,3418.23,148211.94,48211.93999999999
2021-02-20 05:30:00,55742.63,2021-02-20 11:00:00,55867.5,-124.87,148087.06999999998,48087.069999999985
2021-02-20 11:15:00,55965.35,2021-02-20 14:30:00,57292.34,1326.99,149414.06,49414.05999999998
2021-02-20 14:45:00,56363.42,2021-02-20 16:45:00,56811.73,-448.31,148965.75,48965.749999999985
2021-02-20 17:00:00,57450.0,2021-02-20 21:15:00,56642.44,-1081.39,147884.36,47884.359999999986
2021-02-20 22:00:00,56195.0,2021-02-20 22:45:00,55496.05,698.95,148583.31,48583.30999999998
2021-02-20 23:00:00,55922.68,2021-02-21 07:00:00,56460.01,537.33,149120.63999999998,49120.639999999985
2021-02-21 07:15:00,56052.05,2021-02-21 09:30:00,56504.9,-452.85,148667.78999999998,48667.789999999986
2021-02-21 09:45:00,56884.89,2021-02-21 21:30:00,57789.91,905.02,149572.81,49572.80999999998
2021-02-21 21:45:00,57395.57,2021-02-22 07:15:00,56349.83,1045.74,150618.55,50618.54999999998
2021-02-22 07:30:00,56603.88,2021-02-22 09:30:00,55514.9,-1346.92,149271.62999999998,49271.62999999998
2021-02-22 09:45:00,54853.08,2021-02-22 14:15:00,51353.79,3499.29,152770.91999999998,52770.919999999984
2021-02-22 14:30:00,52155.36,2021-02-22 23:45:00,54121.1,1965.74,154736.65999999997,54736.65999999998
2021-02-23 00:00:00,53173.69,2021-02-23 09:45:00,48101.0,5072.69,159809.34999999998,59809.349999999984
2021-02-23 10:00:00,48514.69,2021-02-23 11:15:00,46868.24,-1646.45,158162.9,58162.89999999999
2021-02-23 11:30:00,45262.44,2021-02-23 12:45:00,48705.78,-4162.43,154000.46999999997,54000.46999999999
2021-02-23 13:00:00,49300.64,2021-02-23 19:15:00,46929.61,-2371.03,151629.44,51629.43999999999
2021-02-23 19:30:00,45698.09,2021-02-23 21:15:00,48080.5,-2382.41,149247.02999999997,49247.029999999984
2021-02-23 21:30:00,48449.51,2021-02-24 13:00:00,50462.68,2013.17,151260.19999999998,51260.19999999998
2021-02-24 13:15:00,49639.93,2021-02-24 17:30:00,49888.1,-248.17,151012.02999999997,51012.029999999984
2021-02-24 17:45:00,50103.0,2021-02-24 20:15:00,48920.0,-1183.0,149829.02999999997,49829.029999999984
2021-02-24 20:30:00,48670.67,2021-02-24 23:15:00,49320.71,-650.04,149178.99,49178.98999999998
2021-02-24 23:30:00,49580.06,2021-02-25 08:30:00,50059.04,478.98,149657.96999999997,49657.96999999999
2021-02-25 08:45:00,49733.95,2021-02-25 11:30:00,49787.9,-53.95,149604.02,49604.01999999999
2021-02-25 11:45:00,50333.93,2021-02-25 16:30:00,51026.79,692.86,150296.88,50296.87999999999
2021-02-25 16:45:00,50671.33,2021-02-26 08:45:00,45738.05,4933.28,155230.15999999997,55230.15999999999
2021-02-26 09:00:00,46350.3,2021-02-26 19:15:00,47262.84,912.54,156142.69999999998,56142.69999999999
2021-02-26 19:30:00,46683.41,2021-02-27 00:15:00,46752.0,-68.59,156074.11,56074.10999999999
2021-02-27 00:30:00,47169.14,2021-02-27 07:15:00,47387.92,218.78,156292.88999999998,56292.88999999999
2021-02-27 07:30:00,47113.74,2021-02-27 13:00:00,47411.44,-297.7,155995.19,55995.189999999995
2021-02-27 13:15:00,47604.34,2021-02-27 15:30:00,46586.96,-1235.66,154759.53,54759.52999999999
2021-02-27 21:30:00,46760.21,2021-02-28 00:30:00,46141.18,619.03,155378.56,55378.55999999999
2021-02-28 00:45:00,46354.47,2021-02-28 03:15:00,45403.71,-950.76,154427.8,54427.79999999999
2021-02-28 03:30:00,44684.14,2021-02-28 10:00:00,45174.98,-490.84,153936.96,53936.95999999999
2021-02-28 10:15:00,45370.86,2021-02-28 13:30:00,44649.93,-720.93,153216.03,53216.02999999999
2021-02-28 13:45:00,44208.88,2021-02-28 19:30:00,43797.3,411.58,153627.61,53627.60999999999
2021-02-28 19:45:00,44430.33,2021-03-01 06:15:00,46269.08,1838.75,155466.36,55466.35999999999
2021-03-01 06:30:00,45838.71,2021-03-01 08:00:00,46555.46,-716.75,154749.61,54749.60999999999
2021-03-01 08:15:00,46897.86,2021-03-01 19:00:00,48561.74,1663.88,156413.49,56413.48999999999
2021-03-01 19:15:00,48299.48,2021-03-01 22:15:00,48986.17,-686.69,155726.8,55726.79999999999
2021-03-01 22:30:00,49117.08,2021-03-02 03:00:00,49359.02,241.94,155968.74,55968.73999999999
2021-03-02 03:15:00,48952.78,2021-03-02 13:45:00,49021.82,-69.04,155899.69999999998,55899.69999999999
2021-03-02 14:00:00,49306.45,2021-03-02 15:00:00,48775.5,-530.95,155368.75,55368.74999999999
2021-03-02 15:15:00,48612.26,2021-03-02 23:15:00,48022.18,590.08,155958.83,55958.829999999994
2021-03-02 23:30:00,48330.0,2021-03-03 09:45:00,51541.82,3211.82,159170.65,59170.649999999994
2021-03-03 14:00:00,51100.26,2021-03-04 00:45:00,50907.57,192.69,159363.34,59363.34
2021-03-04 01:00:00,51409.79,2021-03-04 03:00:00,50955.95,-453.84,158909.5,58909.5
2021-03-04 03:15:00,50328.46,2021-03-04 07:45:00,49708.93,619.53,159529.03,59529.03
2021-03-04 08:00:00,50470.0,2021-03-04 09:00:00,49867.75,-602.25,158926.78,58926.78
2021-03-04 09:15:00,48702.56,2021-03-04 14:30:00,49868.28,-1393.08,157533.7,57533.7
2021-03-05 07:00:00,47401.8,2021-03-05 15:45:00,47888.0,486.2,158019.9,58019.899999999994
2021-03-05 16:00:00,47516.74,2021-03-05 17:45:00,48094.05,-577.31,157442.59,57442.59
2021-03-05 18:00:00,48346.88,2021-03-06 01:45:00,48658.54,311.66,157754.25,57754.25
2021-03-06 02:00:00,48374.11,2021-03-06 07:00:00,48848.01,-473.9,157280.35,57280.35
2021-03-06 07:15:00,49056.98,2021-03-06 09:30:00,48410.72,-646.26,156634.09,56634.09
2021-03-06 09:45:00,48363.45,2021-03-06 17:00:00,47755.99,607.46,157241.55,57241.549999999996
2021-03-06 17:15:00,48178.92,2021-03-07 09:15:00,50798.92,2620.0,159861.55,59861.549999999996
2021-03-07 18:45:00,50454.84,2021-03-07 22:45:00,50524.33,-69.49,159792.06,59792.06
2021-03-07 23:00:00,50918.57,2021-03-08 02:15:00,50934.83,16.26,159808.32,59808.32
2021-03-08 02:30:00,50646.65,2021-03-08 11:30:00,50105.39,541.26,160349.58000000002,60349.58
2021-03-08 11:45:00,50529.08,2021-03-09 03:15:00,53834.01,3304.93,163654.51,63654.51
2021-03-09 16:00:00,53880.96,2021-03-09 22:30:00,54429.78,-548.82,163105.69,63105.69
2021-03-09 22:45:00,54858.99,2021-03-10 01:30:00,54882.44,23.45,163129.14,63129.14
2021-03-10 01:45:00,54733.7,2021-03-10 07:00:00,53954.32,779.38,163908.52,63908.52
2021-03-10 07:15:00,54197.53,2021-03-10 20:15:00,56658.99,2461.46,166369.97999999998,66369.98
2021-03-10 20:30:00,56125.11,2021-03-11 10:45:00,55591.24,533.87,166903.84999999998,66903.84999999999
2021-03-11 11:00:00,55637.63,2021-03-12 02:45:00,57030.56,1392.93,168296.77999999997,68296.77999999998
2021-03-12 03:00:00,56965.78,2021-03-12 14:45:00,56276.17,689.61,168986.38999999998,68986.38999999998
2021-03-12 15:00:00,56521.35,2021-03-12 20:15:00,56553.71,32.36,169018.75,69018.74999999999
2021-03-12 20:30:00,56527.39,2021-03-12 23:00:00,57320.1,-792.71,168226.03999999998,68226.03999999998
2021-03-12 23:15:00,57385.01,2021-03-13 00:00:00,56708.66,-676.35,167549.68999999997,67549.68999999997
2021-03-13 00:15:00,56419.06,2021-03-13 06:30:00,56884.11,-465.05,167084.63999999996,67084.63999999997
2021-03-13 06:45:00,57005.01,2021-03-13 17:00:00,59970.74,2965.73,170050.36999999997,70050.36999999997
2021-03-14 02:15:00,60966.33,2021-03-14 12:30:00,60450.0,516.33,170566.69999999995,70566.69999999997
2021-03-14 12:45:00,60516.11,2021-03-14 16:00:00,60024.72,-1113.24,169453.45999999996,69453.45999999996
2021-03-14 23:45:00,59037.12,2021-03-15 01:00:00,59710.01,-672.89,168780.56999999995,68780.56999999996
2021-03-15 01:15:00,60142.98,2021-03-15 04:45:00,59881.18,-261.8,168518.76999999996,68518.76999999996
2021-03-15 05:00:00,59727.15,2021-03-15 12:45:00,56475.27,3251.88,171770.64999999997,71770.64999999997
2021-03-15 13:00:00,56558.67,2021-03-15 23:30:00,56188.84,-369.83,171400.81999999995,71400.81999999996
2021-03-15 23:45:00,55646.61,2021-03-16 04:00:00,54515.0,1131.61,172532.42999999996,72532.42999999996
2021-03-16 04:15:00,54795.66,2021-03-16 12:15:00,55217.99,422.33,172954.75999999995,72954.75999999997
2021-03-16 12:30:00,54890.79,2021-03-16 15:45:00,55885.38,-994.59,171960.16999999998,71960.16999999997
2021-03-16 16:00:00,55973.97,2021-03-17 01:45:00,56330.95,356.98,172317.14999999997,72317.14999999997
2021-03-17 02:00:00,56170.01,2021-03-17 06:00:00,55952.8,217.21,172534.36,72534.35999999997
2021-03-17 06:15:00,56219.7,2021-03-17 09:15:00,55663.1,-556.6,171977.75999999995,71977.75999999997
2021-03-17 09:30:00,54960.86,2021-03-17 16:00:00,55236.0,-275.14,171702.61999999997,71702.61999999997
2021-03-17 16:15:00,55558.23,2021-03-18 02:00:00,59214.4,3656.17,175358.78999999998,75358.78999999996
2021-03-18 07:00:00,58750.83,2021-03-18 15:15:00,58384.3,366.53,175725.31999999995,75725.31999999996
2021-03-18 15:30:00,59026.87,2021-03-18 16:30:00,59821.04,794.17,176519.48999999996,76519.48999999996
2021-03-18 16:45:00,59162.22,2021-03-19 02:00:00,57288.01,1874.21,178393.69999999995,78393.69999999997
2021-03-19 02:15:00,57500.61,2021-03-19 13:15:00,58577.87,1077.26,179470.95999999996,79470.95999999996
2021-03-19 13:30:00,58165.99,2021-03-19 19:45:00,58875.66,-709.67,178761.28999999998,78761.28999999996
2021-03-19 20:00:00,59440.43,2021-03-19 20:15:00,58582.96,-857.47,177903.81999999995,77903.81999999996
2021-03-19 20:30:00,58325.47,2021-03-20 01:45:00,58782.21,-456.74,177447.07999999996,77447.07999999996
2021-03-20 02:00:00,58900.0,2021-03-20 05:15:00,58291.34,-608.66,176838.41999999995,76838.41999999995
2021-03-20 05:30:00,58220.8,2021-03-20 07:45:00,58472.13,-251.33,176587.08999999997,76587.08999999995
2021-03-20 08:00:00,58713.4,2021-03-20 19:45:00,59332.32,618.92,177206.00999999995,77206.00999999995
2021-03-20 20:00:00,58856.9,2021-03-21 09:30:00,55467.37,3389.53,180595.53999999995,80595.53999999995
2021-03-21 13:00:00,56657.57,2021-03-21 22:45:00,57657.62,1000.05,181595.58999999997,81595.58999999995
2021-03-21 23:00:00,57253.4,2021-03-22 03:00:00,57262.39,-8.99,181586.59999999995,81586.59999999995
2021-03-22 03:15:00,57371.88,2021-03-22 11:45:00,57779.3,407.42,181994.01999999996,81994.01999999995
2021-03-22 12:00:00,57472.45,2021-03-23 01:15:00,54856.61,2615.84,184609.85999999993,84609.85999999994
2021-03-23 01:30:00,55196.41,2021-03-23 04:45:00,54494.03,-702.38,183907.47999999992,83907.47999999994
2021-03-23 05:00:00,54204.99,2021-03-23 08:15:00,53972.51,232.48,184139.95999999993,84139.95999999993
2021-03-23 08:30:00,54318.48,2021-03-23 19:45:00,55055.83,737.35,184877.30999999994,84877.30999999994
2021-03-23 20:00:00,54877.47,2021-03-24 03:15:00,54529.04,348.43,185225.73999999993,85225.73999999993
2021-03-24 03:30:00,54664.74,2021-03-24 05:45:00,54155.01,-509.73,184716.00999999995,84716.00999999994
2021-03-24 06:00:00,53816.58,2021-03-24 06:30:00,54766.0,-1175.79,183540.21999999994,83540.21999999994
2021-03-24 07:00:00,55520.74,2021-03-24 15:15:00,56384.95,864.21,184404.42999999993,84404.42999999995
2021-03-24 15:30:00,56122.43,2021-03-25 05:45:00,52683.0,3439.43,187843.85999999993,87843.85999999994
2021-03-25 06:00:00,53171.1,2021-03-25 11:30:00,52529.99,-641.11,187202.74999999994,87202.74999999994
2021-03-25 11:45:00,52197.7,2021-03-25 18:15:00,51762.43,435.27,187638.01999999996,87638.01999999995
2021-03-25 18:30:00,52445.04,2021-03-25 23:15:00,51704.92,-740.12,186897.89999999997,86897.89999999995
2021-03-25 23:30:00,51297.63,2021-03-26 03:00:00,52048.98,-751.35,186146.54999999993,86146.54999999994
2021-03-26 03:15:00,52374.45,2021-03-26 11:30:00,52966.31,591.86,186738.40999999995,86738.40999999995
2021-03-26 11:45:00,52759.34,2021-03-26 16:00:00,53438.91,-679.57,186058.83999999994,86058.83999999994
2021-03-26 16:15:00,53712.99,2021-03-27 02:00:00,54846.52,1133.53,187192.36999999994,87192.36999999994
2021-03-27 02:15:00,54665.09,2021-03-27 15:00:00,54810.0,-144.91,187047.45999999993,87047.45999999993
2021-03-27 15:15:00,54945.73,2021-03-27 23:30:00,56008.66,1062.93,188110.38999999993,88110.38999999993
2021-03-27 23:45:00,55828.0,2021-03-28 04:00:00,56191.44,-363.44,187746.94999999992,87746.94999999992
2021-03-28 04:15:00,56363.83,2021-03-28 09:45:00,56141.4,-222.43,187524.51999999993,87524.51999999993
2021-03-28 10:00:00,55903.79,2021-03-28 15:00:00,55711.0,192.79,187717.30999999994,87717.30999999992
2021-03-28 15:15:00,56241.44,2021-03-28 18:00:00,55777.0,-464.44,187252.86999999994,87252.86999999992
2021-03-28 18:15:00,55632.0,2021-03-28 22:30:00,55323.19,308.81,187561.67999999993,87561.67999999992
2021-03-28 22:45:00,55610.0,2021-03-29 04:00:00,55297.12,-312.88,187248.79999999993,87248.79999999992
2021-03-29 04:15:00,55200.37,2021-03-29 06:45:00,55414.74,-214.37,187034.42999999993,87034.42999999992
2021-03-29 07:00:00,55733.7,2021-03-29 15:00:00,57768.17,2034.47,189068.8999999999,89068.89999999992
2021-03-29 15:15:00,57514.63,2021-03-30 06:00:00,57672.78,-158.15,188910.74999999994,88910.74999999993
2021-03-30 06:15:00,57823.87,2021-03-30 15:30:00,58842.94,1019.07,189929.81999999995,89929.81999999993
2021-03-30 15:45:00,58615.66,2021-03-31 00:30:00,58979.28,-363.62,189566.19999999995,89566.19999999994
2021-03-31 00:45:00,59071.68,2021-03-31 03:15:00,58665.29,-406.39,189159.80999999994,89159.80999999994
2021-03-31 03:30:00,58515.07,2021-03-31 06:00:00,58745.43,-230.36,188929.44999999995,88929.44999999994
2021-03-31 06:15:00,59456.38,2021-03-31 06:15:00,59456.38,-650.57,188278.87999999995,88278.87999999993
2021-03-31 07:45:00,58244.24,2021-03-31 07:45:00,58244.24,-1125.88,187152.99999999994,87152.99999999993
2021-03-31 09:00:00,58227.88,2021-03-31 19:30:00,59168.95,941.07,188094.06999999995,88094.06999999993
2021-03-31 19:45:00,58644.25,2021-04-01 00:30:00,59115.18,-470.93,187623.13999999996,87623.13999999994
2021-04-01 00:45:00,59304.39,2021-04-01 07:00:00,58745.01,-683.18,186939.95999999996,86939.95999999995
2021-04-01 10:45:00,58706.8,2021-04-01 13:15:00,58991.73,-284.93,186655.02999999997,86655.02999999996
2021-04-01 13:30:00,59026.0,2021-04-01 17:30:00,58655.86,-370.14,186284.88999999996,86284.88999999996
2021-04-01 17:45:00,58573.61,2021-04-01 18:45:00,58784.76,-211.15,186073.73999999996,86073.73999999996
2021-04-01 19:00:00,58931.24,2021-04-02 06:00:00,59605.01,673.77,186747.50999999995,86747.50999999997
2021-04-02 06:15:00,59609.99,2021-04-02 23:00:00,58831.6,778.39,187525.89999999997,87525.89999999997
2021-04-02 23:15:00,59196.24,2021-04-03 08:15:00,59605.9,409.66,187935.55999999997,87935.55999999997
2021-04-03 08:30:00,59052.08,2021-04-03 09:30:00,59279.67,-227.59,187707.96999999997,87707.96999999997
2021-04-03 09:45:00,59507.08,2021-04-03 14:30:00,59362.86,-144.22,187563.74999999997,87563.74999999997
2021-04-03 14:45:00,59241.92,2021-04-03 19:30:00,58365.65,876.27,188440.01999999996,88440.01999999997
2021-04-03 19:45:00,58657.0,2021-04-03 21:30:00,58050.28,-606.72,187833.3,87833.29999999997
2021-04-03 21:45:00,57686.0,2021-04-04 03:30:00,57377.52,308.48,188141.77999999997,88141.77999999997
2021-04-04 03:45:00,57545.11,2021-04-04 19:00:00,58124.75,579.64,188721.41999999998,88721.41999999997
2021-04-04 19:15:00,57902.2,2021-04-05 00:00:00,58086.63,-542.54,188178.87999999998,88178.87999999998
2021-04-05 09:45:00,57580.11,2021-04-05 21:15:00,58816.29,1236.18,189415.05999999997,89415.05999999997
2021-04-05 21:30:00,58734.36,2021-04-05 23:30:00,58761.44,-27.08,189387.97999999998,89387.97999999997
2021-04-05 23:45:00,59243.39,2021-04-06 01:30:00,59112.18,-131.21,189256.76999999996,89256.76999999996
2021-04-06 01:45:00,58879.99,2021-04-06 17:15:00,58163.17,716.82,189973.58999999997,89973.58999999997
2021-04-06 17:30:00,58277.16,2021-04-06 21:30:00,57968.69,-612.25,189361.33999999997,89361.33999999997
2021-04-07 00:45:00,57723.21,2021-04-07 03:00:00,57800.01,-76.8,189284.53999999998,89284.53999999996
2021-04-07 03:15:00,58072.31,2021-04-07 04:00:00,57760.72,-311.59,188972.94999999995,88972.94999999997
2021-04-07 04:15:00,57420.86,2021-04-07 05:15:00,57759.5,-338.64,188634.30999999997,88634.30999999997
2021-04-07 05:30:00,58195.08,2021-04-07 07:45:00,57887.07,-308.01,188326.3,88326.29999999997
2021-04-07 08:00:00,57694.16,2021-04-07 14:00:00,56834.58,859.58,189185.87999999998,89185.87999999998
2021-04-07 14:15:00,56887.57,2021-04-07 18:45:00,55929.0,-958.57,188227.30999999997,88227.30999999997
2021-04-07 19:00:00,55746.31,2021-04-07 22:15:00,56374.28,-627.97,187599.33999999997,87599.33999999997
2021-04-07 22:30:00,56600.4,2021-04-08 09:30:00,56928.46,328.06,187927.39999999997,87927.39999999997
2021-04-08 09:45:00,56745.26,2021-04-08 12:15:00,56955.39,-210.13,187717.26999999996,87717.26999999996
2021-04-08 12:30:00,57177.2,2021-04-08 20:45:00,57725.1,547.9,188265.16999999995,88265.16999999995
2021-04-08 21:00:00,57578.58,2021-04-08 23:30:00,58079.8,-501.22,187763.94999999995,87763.94999999995
2021-04-08 23:45:00,58122.26,2021-04-09 06:30:00,58125.42,3.16,187767.10999999996,87767.10999999996
2021-04-09 06:45:00,57899.55,2021-04-09 09:45:00,57959.99,-60.44,187706.66999999995,87706.66999999995
2021-04-09 10:00:00,58393.18,2021-04-09 15:45:00,58301.32,-91.86,187614.80999999994,87614.80999999995
2021-04-09 16:00:00,58033.9,2021-04-09 19:45:00,58398.3,-364.4,187250.40999999997,87250.40999999996
2021-04-09 20:00:00,58619.99,2021-04-09 22:30:00,58227.65,-392.34,186858.06999999995,86858.06999999996
2021-04-09 22:45:00,58134.99,2021-04-10 01:30:00,58300.0,-165.01,186693.05999999997,86693.05999999997
2021-04-10 01:45:00,58444.01,2021-04-10 04:15:00,61759.06,3315.05,190008.11,90008.10999999997
2021-04-10 06:45:00,60697.41,2021-04-10 22:00:00,59344.51,1352.9,191361.00999999995,91361.00999999997
2021-04-10 22:15:00,59390.0,2021-04-11 04:15:00,60196.65,806.65,192167.65999999997,92167.65999999996
2021-04-11 04:30:00,59901.4,2021-04-11 17:30:00,59923.21,-21.81,192145.84999999998,92145.84999999996
2021-04-11 17:45:00,59959.49,2021-04-11 21:00:00,59701.7,-257.79,191888.05999999997,91888.05999999997
2021-04-11 21:15:00,59617.77,2021-04-12 00:00:00,59971.02,-747.59,191140.46999999997,91140.46999999997
2021-04-12 03:30:00,60399.99,2021-04-12 09:15:00,60862.0,462.01,191602.47999999998,91602.47999999997
2021-04-12 09:30:00,60226.32,2021-04-12 12:15:00,60369.7,-143.38,191459.09999999998,91459.09999999996
2021-04-12 12:30:00,60566.4,2021-04-12 17:30:00,59883.32,-683.08,190776.01999999996,90776.01999999996
2021-04-12 17:45:00,59819.66,2021-04-12 23:45:00,59911.18,-91.52,190684.49999999994,90684.49999999996
2021-04-13 00:00:00,60379.94,2021-04-13 04:15:00,60550.51,170.57,190855.06999999995,90855.06999999996
2021-04-13 04:30:00,60488.11,2021-04-13 06:00:00,60896.88,-408.77,190446.29999999996,90446.29999999996
2021-04-13 06:15:00,61444.73,2021-04-13 06:45:00,60815.98,-828.85,189617.44999999995,89617.44999999995
2021-04-13 18:45:00,62768.56,2021-04-13 23:00:00,63316.02,-547.46,189069.98999999993,89069.98999999995
2021-04-13 23:15:00,63335.01,2021-04-14 02:15:00,63317.61,-17.4,189052.58999999997,89052.58999999995
2021-04-14 02:30:00,63200.01,2021-04-14 03:45:00,63857.87,-735.89,188316.69999999995,88316.69999999995
2021-04-14 04:30:00,64040.62,2021-04-14 08:45:00,64000.0,-40.62,188276.07999999996,88276.07999999996
2021-04-14 09:00:00,63878.79,2021-04-14 10:45:00,64168.38,-289.59,187986.48999999996,87986.48999999996
2021-04-14 11:00:00,64540.0,2021-04-14 13:45:00,63868.38,-671.62,187314.86999999997,87314.86999999997
2021-04-14 14:00:00,62867.99,2021-04-14 21:15:00,62737.05,130.94,187445.80999999997,87445.80999999997
2021-04-14 21:30:00,62854.13,2021-04-15 09:30:00,62737.6,-116.53,187329.27999999997,87329.27999999997
2021-04-15 09:45:00,62729.97,2021-04-15 13:00:00,62807.99,-78.02,187251.25999999995,87251.25999999997
2021-04-15 13:15:00,62908.09,2021-04-15 23:15:00,63233.76,325.67,187576.92999999996,87576.92999999996
2021-04-15 23:30:00,63148.09,2021-04-16 14:00:00,60993.79,2154.3,189731.22999999998,89731.22999999997
2021-04-16 14:15:00,61382.19,2021-04-16 23:30:00,61573.1,190.91,189922.13999999996,89922.13999999997
2021-04-16 23:45:00,61424.67,2021-04-17 01:45:00,61943.76,-519.09,189403.05,89403.04999999997
2021-04-17 02:00:00,62062.37,2021-04-17 09:00:00,62247.62,185.25,189588.3,89588.29999999997
2021-04-17 09:15:00,61839.42,2021-04-17 18:45:00,60449.36,1390.06,190978.36,90978.35999999997
2021-04-17 19:00:00,60789.76,2021-04-17 23:15:00,60362.3,-427.46,190550.89999999997,90550.89999999997
2021-04-17 23:30:00,60231.01,2021-04-18 03:15:00,52620.66,7610.35,198161.24999999997,98161.24999999997
2021-04-18 03:45:00,54849.46,2021-04-18 11:15:00,54613.37,-236.09,197925.15999999997,97925.15999999997
2021-04-18 11:30:00,53520.42,2021-04-18 13:45:00,55179.96,-1659.54,196265.62,96265.61999999998
2021-04-18 14:00:00,55235.12,2021-04-19 09:45:00,56746.05,1510.93,197776.55,97776.54999999997
2021-04-19 10:00:00,56409.5,2021-04-19 18:15:00,55590.75,818.75,198595.3,98595.29999999997
2021-04-19 18:30:00,55698.55,2021-04-19 23:45:00,55634.39,-64.16,198531.13999999996,98531.13999999997
2021-04-20 00:00:00,55307.46,2021-04-20 04:15:00,54696.1,611.36,199142.49999999997,99142.49999999997
2021-04-20 04:30:00,54999.97,2021-04-20 06:15:00,54557.32,-442.65,198699.84999999998,98699.84999999998
2021-04-20 06:30:00,54097.24,2021-04-20 07:45:00,54435.0,-337.76,198362.08999999997,98362.08999999998
2021-04-20 08:00:00,54888.03,2021-04-20 15:00:00,55382.52,494.49,198856.58,98856.57999999999
2021-04-20 15:15:00,55049.99,2021-04-20 17:30:00,55753.75,-703.76,198152.82,98152.81999999999
2021-04-20 17:45:00,55884.65,2021-04-21 00:30:00,56149.02,264.37,198417.19,98417.18999999999
2021-04-21 00:45:00,55683.2,2021-04-21 12:30:00,55387.21,295.99,198713.18,98713.18
2021-04-21 12:45:00,55417.62,2021-04-21 18:00:00,55478.37,60.75,198773.93,98773.93
2021-04-21 18:15:00,55453.0,2021-04-22 03:45:00,53505.17,1947.83,200721.76,100721.76
2021-04-22 04:00:00,54020.75,2021-04-22 08:00:00,53833.54,-187.21,200534.55,100534.54999999999
2021-04-22 08:15:00,53674.26,2021-04-22 10:00:00,54225.12,-550.86,199983.69,99983.68999999999
2021-04-22 10:15:00,54380.62,2021-04-22 17:15:00,54399.97,19.35,200003.03999999998,100003.04
2021-04-22 17:30:00,53989.68,2021-04-23 07:45:00,47771.61,6218.07,206221.11,106221.10999999999
2021-04-23 10:30:00,49572.5,2021-04-24 00:15:00,50102.41,529.91,206751.02,106751.01999999999
2021-04-24 00:30:00,49857.12,2021-04-24 04:15:00,50247.08,-389.96,206361.06,106361.05999999998
2021-04-24 04:30:00,50447.17,2021-04-24 08:45:00,49799.78,-647.39,205713.66999999998,105713.66999999998
2021-04-24 09:00:00,49714.41,2021-04-24 15:15:00,49720.0,-5.59,205708.08,105708.07999999999
2021-04-24 15:30:00,49962.99,2021-04-24 23:30:00,50353.94,390.95,206099.02999999997,106099.02999999998
2021-04-24 23:45:00,50092.4,2021-04-25 08:30:00,49775.65,316.75,206415.77999999997,106415.77999999998
2021-04-25 08:45:00,50122.88,2021-04-25 09:15:00,49428.94,-693.94,205721.83999999997,105721.83999999998
2021-04-25 09:30:00,49376.91,2021-04-25 14:00:00,49737.89,-360.98,205360.86,105360.85999999999
2021-04-25 14:15:00,50055.0,2021-04-25 18:00:00,49853.62,-201.38,205159.47999999998,105159.47999999998
2021-04-25 18:15:00,49649.84,2021-04-25 22:15:00,47940.88,1708.96,206868.44,106868.43999999999
2021-04-25 22:30:00,48425.11,2021-04-26 04:00:00,52576.59,4151.48,211019.91999999998,111019.91999999998
2021-04-26 20:15:00,53196.15,2021-04-26 23:15:00,53813.47,-617.32,210402.59999999998,110402.59999999998
2021-04-26 23:30:00,53862.01,2021-04-28 03:15:00,55122.35,1260.34,211662.93999999997,111662.93999999997
2021-04-28 03:30:00,54884.71,2021-04-28 10:45:00,54425.18,459.53,212122.46999999997,112122.46999999997
2021-04-28 11:00:00,54729.08,2021-04-28 14:15:00,54686.44,-42.64,212079.82999999996,112079.82999999997
2021-04-28 14:30:00,54527.67,2021-04-28 17:15:00,54805.51,-277.84,211801.99,111801.98999999998
2021-04-28 17:30:00,54967.81,2021-04-28 20:00:00,55556.99,589.18,212391.16999999998,112391.16999999997
2021-04-28 20:15:00,54805.14,2021-04-28 23:45:00,54861.77,-56.63,212334.53999999998,112334.53999999996
2021-04-29 00:00:00,54976.95,2021-04-29 03:15:00,54500.01,-476.94,211857.59999999998,111857.59999999996
2021-04-29 03:30:00,54236.51,2021-04-29 06:00:00,54225.62,10.89,211868.48999999996,111868.48999999996
2021-04-29 06:15:00,54349.99,2021-04-29 13:00:00,54165.11,-184.88,211683.60999999996,111683.60999999996
2021-04-29 13:15:00,53984.56,2021-04-29 21:30:00,53031.48,953.08,212636.68999999994,112636.68999999996
2021-04-29 21:45:00,53336.57,2021-04-30 14:00:00,56130.31,2793.74,215430.42999999996,115430.42999999996
2021-05-01 08:30:00,57610.12,2021-05-01 11:45:00,57846.83,-236.71,215193.71999999997,115193.71999999996
2021-05-01 12:00:00,58012.47,2021-05-01 14:45:00,57479.48,-532.99,214660.72999999995,114660.72999999995
2021-05-01 15:00:00,57301.53,2021-05-01 19:00:00,57567.26,-265.73,214394.99999999994,114394.99999999996
2021-05-01 19:15:00,58028.91,2021-05-01 21:45:00,57499.43,-610.05,213784.94999999995,113784.94999999995
2021-05-02 00:45:00,57496.02,2021-05-02 05:00:00,56865.01,631.01,214415.95999999996,114415.95999999995
2021-05-02 05:15:00,57045.24,2021-05-02 08:00:00,56465.12,-580.12,213835.83999999997,113835.83999999995
2021-05-02 08:15:00,56348.87,2021-05-02 11:30:00,56742.76,-393.89,213441.94999999995,113441.94999999995
2021-05-02 11:45:00,57158.17,2021-05-02 15:30:00,56693.7,-464.47,212977.47999999995,112977.47999999995
2021-05-02 15:45:00,56654.38,2021-05-02 20:30:00,56813.32,-158.94,212818.53999999995,112818.53999999995
2021-05-02 20:45:00,57056.39,2021-05-02 22:00:00,56603.2,-453.19,212365.34999999995,112365.34999999995
2021-05-02 22:15:00,56508.65,2021-05-02 23:45:00,56630.33,-121.68,212243.66999999995,112243.66999999995
2021-05-03 00:00:00,57025.04,2021-05-03 13:30:00,58300.0,1274.96,213518.62999999995,113518.62999999996
2021-05-03 13:45:00,57774.53,2021-05-04 02:15:00,55769.54,2004.99,215523.61999999997,115523.61999999997
2021-05-04 02:30:00,55818.63,2021-05-04 13:30:00,55727.38,-91.25,215432.36999999997,115432.36999999997
2021-05-04 13:45:00,55552.5,2021-05-04 19:15:00,54358.95,1193.55,216625.91999999998,116625.91999999997
2021-05-04 19:30:00,54498.58,2021-05-04 22:15:00,54033.34,-465.24,216160.67999999996,116160.67999999996
2021-05-04 22:30:00,53666.63,2021-05-05 00:15:00,54088.47,-421.84,215738.83999999997,115738.83999999997
2021-05-05 00:30:00,54697.94,2021-05-05 06:15:00,54385.32,-312.62,215426.21999999997,115426.21999999997
2021-05-05 06:30:00,54115.17,2021-05-05 08:00:00,54755.27,-640.1,214786.11999999997,114786.11999999997
2021-05-05 08:15:00,55284.94,2021-05-05 20:15:00,56920.74,1635.8,216421.91999999998,116421.91999999997
2021-05-05 20:30:00,56844.37,2021-05-06 09:15:00,57237.63,-393.26,216028.65999999997,116028.65999999997
2021-05-06 09:30:00,57376.99,2021-05-06 12:45:00,57713.55,336.56,216365.21999999997,116365.21999999997
2021-05-06 13:00:00,57461.5,2021-05-06 22:15:00,56295.65,1165.85,217531.06999999998,117531.06999999998
2021-05-06 22:30:00,56526.07,2021-05-07 02:00:00,56349.0,-177.07,217353.99999999997,117353.99999999997
2021-05-07 02:15:00,55954.16,2021-05-07 07:00:00,56183.37,-229.21,217124.78999999998,117124.78999999996
2021-05-07 07:15:00,56287.38,2021-05-07 19:00:00,57915.0,1627.62,218752.40999999997,118752.40999999996
2021-05-07 19:15:00,57708.19,2021-05-08 01:15:00,57580.2,127.99,218880.39999999997,118880.39999999997
2021-05-08 01:30:00,57832.99,2021-05-08 05:45:00,57947.14,114.15,218994.54999999996,118994.54999999996
2021-05-08 06:00:00,57822.82,2021-05-08 07:30:00,58224.25,-401.43,218593.11999999997,118593.11999999997
2021-05-08 07:45:00,58500.0,2021-05-08 10:15:00,58854.96,354.96,218948.07999999996,118948.07999999997
2021-05-08 10:30:00,58466.78,2021-05-08 13:00:00,58979.03,-512.25,218435.82999999996,118435.82999999997
2021-05-08 13:15:00,59258.91,2021-05-08 15:30:00,58548.06,-710.85,217724.97999999998,117724.97999999997
2021-05-08 15:45:00,57660.76,2021-05-08 16:45:00,58441.63,-780.87,216944.11,116944.10999999997
2021-05-08 17:00:00,58941.0,2021-05-08 23:15:00,58648.56,-292.44,216651.66999999998,116651.66999999997
2021-05-08 23:30:00,58654.27,2021-05-09 15:00:00,57258.3,1395.97,218047.63999999996,118047.63999999997
2021-05-09 15:15:00,57409.47,2021-05-10 06:45:00,58936.73,1527.26,219574.89999999997,119574.89999999997
2021-05-10 07:00:00,58833.94,2021-05-10 15:30:00,57371.1,1462.84,221037.73999999996,121037.73999999996
2021-05-10 15:45:00,58359.23,2021-05-10 17:15:00,57475.4,-883.83,220153.90999999997,120153.90999999996
2021-05-10 17:30:00,57287.21,2021-05-10 20:15:00,55090.29,2196.92,222350.82999999996,122350.82999999996
2021-05-10 20:30:00,55278.7,2021-05-11 02:30:00,55388.93,110.23,222461.05999999994,122461.05999999995
2021-05-11 02:45:00,54684.65,2021-05-11 07:30:00,55514.53,-829.88,221631.17999999993,121631.17999999995
2021-05-11 07:45:00,55792.83,2021-05-11 12:00:00,55309.46,-483.37,221147.80999999994,121147.80999999995
2021-05-11 12:15:00,54988.09,2021-05-11 15:00:00,55908.34,-920.25,220227.55999999994,120227.55999999995
2021-05-11 15:15:00,56124.0,2021-05-12 06:00:00,57248.16,1124.16,221351.71999999997,121351.71999999996
2021-05-12 06:15:00,57168.5,2021-05-12 22:00:00,51789.35,5379.15,226730.86999999994,126730.86999999995
2021-05-13 00:15:00,49617.64,2021-05-13 09:00:00,50024.47,406.83,227137.69999999995,127137.69999999995
2021-05-13 09:15:00,49829.38,2021-05-13 12:00:00,50088.68,-259.3,226878.39999999997,126878.39999999995
2021-05-13 12:15:00,50287.47,2021-05-13 16:30:00,49590.44,-697.03,226181.36999999994,126181.36999999995
2021-05-13 16:45:00,48685.42,2021-05-13 19:15:00,48899.81,-214.39,225966.97999999995,125966.97999999995
2021-05-13 19:30:00,49303.3,2021-05-14 04:15:00,49308.72,5.42,225972.39999999997,125972.39999999995
2021-05-14 04:30:00,48894.19,2021-05-14 07:30:00,49991.08,-1297.96,224674.43999999994,124674.43999999994
2021-05-14 08:00:00,50326.51,2021-05-14 17:30:00,50713.16,386.65,225061.08999999994,125061.08999999994
2021-05-14 17:45:00,50622.4,2021-05-14 23:45:00,49873.27,749.13,225810.21999999994,125810.21999999994
2021-05-15 00:00:00,50159.04,2021-05-15 03:30:00,49877.92,-281.12,225529.09999999995,125529.09999999995
2021-05-15 03:45:00,49675.11,2021-05-15 12:15:00,48889.93,785.18,226314.27999999994,126314.27999999994
2021-05-15 12:30:00,49172.53,2021-05-15 16:00:00,48369.24,-803.29,225510.98999999993,125510.98999999995
2021-05-15 16:15:00,47902.01,2021-05-15 19:45:00,48157.36,-255.35,225255.63999999996,125255.63999999994
2021-05-15 20:00:00,48385.0,2021-05-15 23:15:00,47479.22,-905.78,224349.85999999993,124349.85999999994
2021-05-15 23:30:00,46802.57,2021-05-16 01:30:00,47994.91,-1192.34,223157.51999999996,123157.51999999995
2021-05-16 01:45:00,48089.36,2021-05-16 12:15:00,49036.23,946.87,224104.38999999996,124104.38999999994
2021-05-16 12:30:00,48815.78,2021-05-16 23:00:00,45586.66,3229.12,227333.50999999995,127333.50999999994
2021-05-16 23:15:00,45958.35,2021-05-17 02:15:00,44868.27,-1090.08,226243.42999999993,126243.42999999993
2021-05-17 02:30:00,44424.87,2021-05-17 05:45:00,44250.94,173.93,226417.35999999993,126417.35999999993
2021-05-17 06:00:00,45040.21,2021-05-17 13:45:00,45072.32,32.11,226449.4699999999,126449.46999999993
2021-05-17 14:00:00,44286.98,2021-05-17 19:00:00,43975.0,311.98,226761.44999999992,126761.44999999992
2021-05-17 19:15:00,44157.73,2021-05-17 22:15:00,43523.01,-634.72,226126.72999999992,126126.72999999992
2021-05-17 22:30:00,43158.67,2021-05-18 00:00:00,44185.11,-1026.44,225100.28999999992,125100.28999999992
2021-05-18 00:15:00,44484.66,2021-05-18 12:00:00,45042.16,557.5,225657.78999999992,125657.78999999992
2021-05-18 12:15:00,44724.49,2021-05-19 04:30:00,38973.84,5750.65,231408.43999999992,131408.43999999992
2021-05-19 08:15:00,40333.54,2021-05-19 11:00:00,39439.76,-893.78,230514.65999999992,130514.65999999992
2021-05-19 11:15:00,38171.06,2021-05-19 11:30:00,38407.79,-236.73,230277.92999999993,130277.92999999992
2021-05-19 11:45:00,38708.85,2021-05-19 12:15:00,38350.27,-358.58,229919.34999999992,129919.34999999992
2021-05-19 12:30:00,36430.7,2021-05-19 13:15:00,33258.91,3171.79,233091.13999999993,133091.13999999993
2021-05-19 13:30:00,35900.0,2021-05-19 23:30:00,37527.7,1627.7,234718.83999999994,134718.83999999994
2021-05-19 23:45:00,36689.14,2021-05-20 02:30:00,37800.01,-1110.87,233607.96999999994,133607.96999999994
2021-05-20 02:45:00,38054.78,2021-05-20 15:45:00,41448.84,3394.06,237002.02999999994,137002.02999999994
2021-05-20 16:00:00,39438.63,2021-05-20 19:00:00,39693.14,-254.51,236747.51999999993,136747.51999999993
2021-05-20 19:15:00,40272.84,2021-05-21 03:00:00,40932.99,660.15,237407.66999999993,137407.66999999993
2021-05-21 03:15:00,40560.01,2021-05-21 09:15:00,40415.42,144.59,237552.25999999992,137552.25999999992
2021-05-21 09:30:00,41067.54,2021-05-21 14:00:00,40529.64,-537.9,237014.35999999993,137014.35999999993
2021-05-21 14:15:00,38444.51,2021-05-21 14:15:00,38444.51,-2197.31,234817.04999999993,134817.04999999993
2021-05-21 21:30:00,36538.05,2021-05-22 04:15:00,36449.73,-88.32,234728.72999999992,134728.72999999992
2021-05-22 04:30:00,36384.56,2021-05-22 09:00:00,36787.21,-402.65,234326.07999999993,134326.07999999993
2021-05-22 09:15:00,37100.0,2021-05-22 19:30:00,37820.56,720.56,235046.63999999993,135046.63999999993
2021-05-22 19:45:00,37275.3,2021-05-23 00:15:00,37534.25,-258.95,234787.68999999992,134787.68999999992
2021-05-23 00:30:00,38085.01,2021-05-23 04:00:00,37349.12,-735.89,234051.7999999999,134051.7999999999
2021-05-23 04:15:00,37256.64,2021-05-23 19:45:00,33033.85,4222.79,238274.5899999999,138274.5899999999
2021-05-23 20:00:00,33628.49,2021-05-24 12:15:00,38135.46,4506.97,242781.5599999999,142781.5599999999
2021-05-24 22:30:00,38100.84,2021-05-25 00:15:00,39430.77,-1329.93,241451.62999999992,141451.62999999992
2021-05-25 00:30:00,39626.61,2021-05-25 01:45:00,38800.94,-825.67,240625.9599999999,140625.9599999999
2021-05-25 02:00:00,38297.05,2021-05-25 06:45:00,38870.0,-572.95,240053.0099999999,140053.0099999999
2021-05-25 07:00:00,39050.01,2021-05-25 09:30:00,38043.93,-1195.55,238857.4599999999,138857.4599999999
2021-05-25 09:45:00,37947.47,2021-05-25 14:00:00,37829.5,117.97,238975.4299999999,138975.4299999999
2021-05-25 14:15:00,37947.53,2021-05-25 19:30:00,37725.07,-222.46,238752.9699999999,138752.9699999999
2021-05-25 19:45:00,37293.26,2021-05-25 21:45:00,37943.6,-650.34,238102.62999999992,138102.62999999992
2021-05-25 22:00:00,38140.01,2021-05-26 09:45:00,40165.3,2025.29,240127.91999999993,140127.91999999993
2021-05-26 10:00:00,39731.92,2021-05-26 21:30:00,38721.51,1010.41,241138.32999999993,141138.32999999993
2021-05-26 21:45:00,39021.59,2021-05-27 00:45:00,38616.8,-404.79,240733.53999999992,140733.53999999992
2021-05-27 01:00:00,38313.55,2021-05-27 06:15:00,38063.27,250.28,240983.81999999992,140983.81999999992
2021-05-27 06:30:00,38182.39,2021-05-27 16:00:00,39351.39,1169.0,242152.81999999992,142152.81999999992
2021-05-27 16:15:00,39177.4,2021-05-28 12:00:00,36529.29,2648.11,244800.9299999999,144800.9299999999
2021-05-28 12:15:00,36712.71,2021-05-28 16:30:00,36260.59,-452.12,244348.8099999999,144348.8099999999
2021-05-28 16:45:00,35824.93,2021-05-29 00:30:00,35872.9,-47.97,244300.8399999999,144300.8399999999
2021-05-29 00:45:00,36218.56,2021-05-29 07:15:00,36524.92,306.36,244607.1999999999,144607.1999999999
2021-05-29 07:30:00,36159.2,2021-05-29 23:00:00,34402.26,1756.94,246364.1399999999,146364.1399999999
2021-05-29 23:15:00,34831.14,2021-05-30 00:00:00,34237.42,-593.72,245770.4199999999,145770.4199999999
2021-05-30 00:15:00,33924.73,2021-05-30 02:15:00,34335.54,-410.81,245359.6099999999,145359.6099999999
2021-05-30 02:30:00,34492.01,2021-05-30 13:15:00,35684.19,1192.18,246551.7899999999,146551.7899999999
2021-05-30 13:30:00,35545.6,2021-05-30 17:45:00,35826.07,-280.47,246271.3199999999,146271.3199999999
2021-05-30 18:00:00,35948.38,2021-05-30 22:45:00,35761.56,-186.82,246084.49999999988,146084.49999999988
2021-05-30 23:00:00,35566.44,2021-05-31 06:30:00,34833.06,733.38,246817.8799999999,146817.8799999999
2021-05-31 06:45:00,35033.82,2021-05-31 19:15:00,36700.83,1667.01,248484.8899999999,148484.8899999999
2021-05-31 19:30:00,36645.79,2021-05-31 23:00:00,37026.55,-380.76,248104.1299999999,148104.1299999999
2021-05-31 23:15:00,37297.82,2021-06-01 01:45:00,37196.69,-101.13,248002.99999999988,148002.99999999988
2021-06-01 02:00:00,36865.32,2021-06-01 05:30:00,37100.0,-234.68,247768.3199999999,147768.3199999999
2021-06-01 05:45:00,37259.17,2021-06-01 07:45:00,36817.43,-441.74,247326.5799999999,147326.5799999999
2021-06-01 08:00:00,36260.01,2021-06-01 13:00:00,35791.86,468.15,247794.7299999999,147794.7299999999
2021-06-01 13:15:00,36516.55,2021-06-01 14:45:00,36646.53,129.98,247924.7099999999,147924.7099999999
2021-06-01 15:00:00,36289.49,2021-06-01 23:00:00,36492.37,-202.88,247721.8299999999,147721.8299999999
2021-06-01 23:15:00,36738.39,2021-06-02 01:15:00,36065.9,-672.49,247049.3399999999,147049.3399999999
2021-06-02 01:30:00,36093.91,2021-06-02 05:00:00,36517.87,-708.21,246341.12999999992,146341.12999999992
2021-06-02 05:45:00,36801.0,2021-06-02 22:00:00,37737.37,936.37,247277.4999999999,147277.4999999999
2021-06-02 22:15:00,37565.24,2021-06-03 03:45:00,37623.5,-58.26,247219.2399999999,147219.2399999999
2021-06-03 04:00:00,37737.22,2021-06-03 11:45:00,38783.65,1046.43,248265.6699999999,148265.6699999999
2021-06-03 12:00:00,38659.35,2021-06-03 22:00:00,38914.95,-255.6,248010.0699999999,148010.0699999999
2021-06-03 22:15:00,38940.0,2021-06-04 00:45:00,38707.86,-232.14,247777.92999999988,147777.92999999988
2021-06-04 01:00:00,38260.0,2021-06-04 12:30:00,36700.0,1560.0,249337.92999999988,149337.92999999988
2021-06-04 12:45:00,36894.95,2021-06-05 09:30:00,37354.29,459.34,249797.26999999987,149797.26999999987
2021-06-05 09:45:00,36312.98,2021-06-05 09:45:00,36312.98,-976.73,248820.53999999986,148820.53999999986
2021-06-05 10:15:00,36618.56,2021-06-05 12:00:00,35794.7,-1077.09,247743.44999999987,147743.44999999987
2021-06-05 14:00:00,35559.78,2021-06-05 19:15:00,36177.75,-719.45,247023.99999999985,147023.99999999985
2021-06-06 01:00:00,35701.0,2021-06-06 06:00:00,36120.8,419.8,247443.79999999984,147443.79999999984
2021-06-06 06:15:00,35823.55,2021-06-06 14:30:00,35775.13,48.42,247492.21999999986,147492.21999999986
2021-06-06 14:45:00,36106.83,2021-06-06 18:00:00,35989.0,-117.83,247374.38999999987,147374.38999999987
2021-06-06 18:15:00,35906.95,2021-06-06 23:30:00,35709.44,197.51,247571.89999999988,147571.89999999988
2021-06-06 23:45:00,35801.71,2021-06-07 06:00:00,36275.1,473.39,248045.2899999999,148045.2899999999
2021-06-07 06:15:00,36155.55,2021-06-07 10:00:00,36392.25,-236.7,247808.58999999988,147808.58999999988
2021-06-07 10:15:00,36548.47,2021-06-07 13:45:00,36323.63,-224.84,247583.74999999988,147583.74999999988
2021-06-07 14:00:00,36139.69,2021-06-08 02:30:00,32963.73,3175.96,250759.70999999988,150759.70999999988
2021-06-08 07:15:00,33086.88,2021-06-08 13:30:00,32677.01,-409.87,250349.83999999988,150349.83999999988
2021-06-08 13:45:00,32377.74,2021-06-08 15:45:00,31686.94,690.8,251040.63999999987,151040.63999999987
2021-06-08 16:00:00,32144.81,2021-06-09 00:00:00,33041.49,896.68,251937.31999999986,151937.31999999986
2021-06-09 00:15:00,32920.05,2021-06-09 05:00:00,33170.98,-250.93,251686.38999999987,151686.38999999987
2021-06-09 05:15:00,33536.7,2021-06-09 18:45:00,35870.66,2333.96,254020.34999999986,154020.34999999986
2021-06-09 19:00:00,35702.6,2021-06-09 21:45:00,36603.55,-1029.48,252990.86999999985,152990.86999999985
2021-06-09 22:15:00,37143.01,2021-06-10 04:15:00,36857.86,-285.15,252705.71999999986,152705.71999999986
2021-06-10 04:30:00,36694.9,2021-06-10 09:30:00,37137.21,-442.31,252263.40999999986,152263.40999999986
2021-06-10 09:45:00,37404.26,2021-06-10 12:00:00,37691.61,287.35,252550.75999999986,152550.75999999986
2021-06-10 12:15:00,37430.01,2021-06-10 21:45:00,36683.62,746.39,253297.14999999988,153297.14999999988
2021-06-10 22:00:00,36865.0,2021-06-11 01:00:00,36205.1,-659.9,252637.24999999988,152637.24999999988
2021-06-11 01:15:00,36066.65,2021-06-11 03:45:00,36739.45,-672.8,251964.4499999999,151964.4499999999
2021-06-11 04:00:00,36784.4,2021-06-11 06:30:00,36683.07,-101.33,251863.1199999999,151863.1199999999
2021-06-11 06:45:00,36491.89,2021-06-11 09:00:00,37224.15,-732.26,251130.8599999999,151130.8599999999
2021-06-11 09:15:00,37314.69,2021-06-11 15:15:00,36929.91,-384.78,250746.0799999999,150746.0799999999
2021-06-11 15:30:00,36907.2,2021-06-11 19:00:00,37105.03,-197.83,250548.2499999999,150548.2499999999
2021-06-11 19:15:00,37288.07,2021-06-12 01:00:00,37033.44,-254.63,250293.6199999999,150293.6199999999
2021-06-12 01:15:00,36543.06,2021-06-12 10:15:00,34921.9,1621.16,251914.7799999999,151914.7799999999
2021-06-12 10:30:00,35640.24,2021-06-12 15:15:00,35438.21,-202.03,251712.7499999999,151712.7499999999
2021-06-12 15:30:00,35453.99,2021-06-12 20:00:00,35840.02,-386.03,251326.7199999999,151326.7199999999
2021-06-12 20:15:00,35860.0,2021-06-12 23:30:00,35728.56,-131.44,251195.2799999999,151195.2799999999
2021-06-12 23:45:00,35537.05,2021-06-13 07:00:00,35327.99,209.06,251404.3399999999,151404.3399999999
2021-06-13 07:15:00,35358.66,2021-06-13 19:30:00,37473.58,2114.92,253519.25999999992,153519.25999999992
2021-06-14 03:00:00,38864.33,2021-06-14 06:30:00,39292.17,-427.84,253091.41999999993,153091.41999999993
2021-06-14 06:45:00,39599.99,2021-06-14 11:45:00,39151.68,-448.31,252643.10999999993,152643.10999999993
2021-06-14 12:00:00,39094.63,2021-06-14 12:45:00,39566.99,-472.36,252170.74999999994,152170.74999999994
2021-06-14 13:00:00,40492.01,2021-06-14 13:00:00,40492.01,-853.27,251317.47999999995,151317.47999999995
2021-06-14 16:30:00,39849.97,2021-06-14 21:30:00,40101.8,-251.83,251065.64999999997,151065.64999999997
2021-06-14 21:45:00,40240.02,2021-06-15 01:30:00,40060.05,-179.97,250885.67999999996,150885.67999999996
2021-06-15 01:45:00,39920.0,2021-06-15 12:30:00,39898.04,21.96,250907.63999999996,150907.63999999996
2021-06-15 12:45:00,40416.59,2021-06-15 18:45:00,40588.09,171.5,251079.13999999996,151079.13999999996
2021-06-15 19:00:00,40466.99,2021-06-15 23:00:00,40120.4,346.59,251425.72999999995,151425.72999999995
2021-06-15 23:15:00,40252.18,2021-06-16 10:15:00,39946.66,-305.52,251120.20999999996,151120.20999999996
2021-06-16 10:30:00,39710.1,2021-06-17 02:00:00,38787.88,922.22,252042.42999999996,152042.42999999996
2021-06-17 02:15:00,38802.12,2021-06-17 11:45:00,39156.01,353.89,252396.31999999998,152396.31999999998
2021-06-17 12:00:00,38860.01,2021-06-17 15:30:00,38908.58,-48.57,252347.74999999997,152347.74999999997
2021-06-17 15:45:00,39002.18,2021-06-17 16:45:00,38509.83,-705.42,251642.32999999996,151642.32999999996
2021-06-17 17:00:00,38248.82,2021-06-17 22:45:00,37930.82,318.0,251960.32999999996,151960.32999999996
2021-06-17 23:00:00,38110.0,2021-06-18 01:45:00,37644.46,-465.54,251494.78999999995,151494.78999999995
2021-06-18 02:00:00,37408.47,2021-06-18 03:30:00,37865.31,-456.84,251037.94999999995,151037.94999999995
2021-06-18 03:45:00,37905.6,2021-06-18 06:30:00,37595.03,-310.57,250727.37999999995,150727.37999999995
2021-06-18 06:45:00,37446.75,2021-06-18 10:30:00,37759.74,-312.99,250414.38999999996,150414.38999999996
2021-06-18 10:45:00,37813.38,2021-06-18 12:45:00,37430.57,-382.81,250031.57999999996,150031.57999999996
2021-06-18 13:00:00,37168.89,2021-06-18 23:45:00,35811.41,1357.48,251389.05999999997,151389.05999999997
2021-06-19 00:00:00,35893.3,2021-06-19 02:30:00,35589.0,-304.3,251084.75999999998,151084.75999999998
2021-06-19 02:45:00,35484.13,2021-06-19 06:00:00,35530.04,-45.91,251038.84999999998,151038.84999999998
2021-06-19 06:15:00,35568.5,2021-06-19 12:30:00,35933.79,365.29,251404.13999999998,151404.13999999998
2021-06-19 12:45:00,35731.02,2021-06-19 20:30:00,35893.0,-161.98,251242.15999999997,151242.15999999997
2021-06-19 20:45:00,36079.31,2021-06-19 22:30:00,35620.02,-459.29,250782.86999999997,150782.86999999997
2021-06-19 22:45:00,35552.97,2021-06-20 04:30:00,35764.69,-211.72,250571.14999999997,150571.14999999997
2021-06-20 04:45:00,35788.19,2021-06-20 08:15:00,35485.81,-302.38,250268.76999999996,150268.76999999996
2021-06-20 08:30:00,35343.41,2021-06-20 14:30:00,34135.55,1207.86,251476.62999999995,151476.62999999995
2021-06-20 14:45:00,34296.97,2021-06-21 00:00:00,35394.08,1097.11,252573.73999999993,152573.73999999993
2021-06-21 00:15:00,35341.54,2021-06-21 21:00:00,32201.76,3139.78,255713.51999999993,155713.51999999993
2021-06-22 01:00:00,32780.21,2021-06-22 07:45:00,32641.51,-138.7,255574.81999999992,155574.81999999992
2021-06-22 08:00:00,32295.44,2021-06-22 14:45:00,30500.27,1795.17,257369.98999999993,157369.98999999993
2021-06-22 15:00:00,30677.75,2021-06-22 23:45:00,32496.0,1818.25,259188.23999999993,159188.23999999993
2021-06-23 00:00:00,31935.73,2021-06-23 00:15:00,32353.33,-417.6,258770.63999999993,158770.63999999993
2021-06-23 00:30:00,33578.12,2021-06-23 14:45:00,34047.7,469.58,259240.2199999999,159240.2199999999
2021-06-23 15:00:00,33537.05,2021-06-23 23:15:00,33569.16,-32.11,259208.10999999993,159208.10999999993
2021-06-23 23:30:00,33638.53,2021-06-24 01:15:00,33076.75,-561.78,258646.32999999993,158646.32999999993
2021-06-24 01:30:00,32878.39,2021-06-24 06:45:00,32983.43,-105.04,258541.28999999992,158541.28999999992
2021-06-24 07:00:00,33071.03,2021-06-24 21:15:00,34810.88,1739.85,260281.13999999993,160281.13999999993
2021-06-24 21:30:00,34662.28,2021-06-25 01:45:00,34816.64,-154.36,260126.77999999994,160126.77999999994
2021-06-25 02:00:00,35400.0,2021-06-25 04:15:00,34779.07,-620.93,259505.84999999995,159505.84999999995
2021-06-25 04:30:00,34691.18,2021-06-25 22:45:00,31436.66,3254.52,262760.36999999994,162760.36999999994
2021-06-26 04:30:00,32120.0,2021-06-26 06:15:00,32292.17,172.17,262932.5399999999,162932.53999999995
2021-06-26 06:30:00,31789.6,2021-06-26 10:45:00,31064.09,725.51,263658.04999999993,163658.04999999996
2021-06-26 11:00:00,31498.65,2021-06-26 13:30:00,31009.51,-489.14,263168.9099999999,163168.90999999995
2021-06-26 13:45:00,30799.99,2021-06-26 17:30:00,31198.6,-398.61,262770.29999999993,162770.29999999996
2021-06-26 17:45:00,31665.47,2021-06-26 21:00:00,31005.72,-659.75,262110.54999999996,162110.54999999996
2021-06-26 21:15:00,31000.86,2021-06-26 22:45:00,31736.84,-735.98,261374.56999999995,161374.56999999995
2021-06-26 23:00:00,31858.01,2021-06-27 09:15:00,32930.01,1072.0,262446.56999999995,162446.56999999995
2021-06-27 09:30:00,32564.86,2021-06-27 12:00:00,33121.25,-556.39,261890.17999999993,161890.17999999993
2021-06-27 12:15:00,33270.0,2021-06-27 17:45:00,33000.01,-269.99,261620.18999999994,161620.18999999994
2021-06-27 18:00:00,32618.73,2021-06-27 21:45:00,32839.99,-221.26,261398.92999999993,161398.92999999993
2021-06-27 22:00:00,33680.27,2021-06-27 22:00:00,33680.27,-845.75,260553.17999999993,160553.17999999993
2021-06-28 04:45:00,34348.94,2021-06-28 07:15:00,34752.73,-403.79,260149.38999999993,160149.38999999993
2021-06-28 07:30:00,35121.54,2021-06-28 09:30:00,34586.72,-534.82,259614.56999999992,159614.56999999992
2021-06-28 09:45:00,34381.96,2021-06-28 15:15:00,34490.61,-108.65,259505.91999999993,159505.91999999993
2021-06-28 15:30:00,34607.9,2021-06-28 17:15:00,34488.17,-119.73,259386.18999999992,159386.18999999992
2021-06-28 17:30:00,34149.06,2021-06-28 20:30:00,34559.02,-409.96,258976.22999999992,158976.22999999992
2021-06-28 20:45:00,34651.72,2021-06-29 02:00:00,34715.36,63.64,259039.86999999994,159039.86999999994
2021-06-29 02:15:00,34363.67,2021-06-29 06:00:00,34683.1,-319.43,258720.43999999994,158720.43999999994
2021-06-29 06:15:00,34920.52,2021-06-29 21:45:00,36226.33,1305.81,260026.24999999994,160026.24999999994
2021-06-29 22:00:00,36005.77,2021-06-30 18:15:00,34613.78,1391.99,261418.23999999993,161418.23999999993
2021-06-30 18:30:00,34837.9,2021-07-01 01:45:00,34923.04,85.14,261503.37999999995,161503.37999999995
2021-07-01 02:00:00,34573.61,2021-07-01 11:30:00,33518.31,1055.3,262558.67999999993,162558.67999999993
2021-07-01 11:45:00,33696.91,2021-07-01 14:15:00,33181.99,-514.92,262043.75999999992,162043.75999999992
2021-07-01 14:30:00,33120.26,2021-07-01 20:30:00,33392.84,-272.58,261771.17999999993,161771.17999999993
2021-07-01 20:45:00,33386.45,2021-07-02 01:30:00,33415.32,28.87,261800.04999999993,161800.04999999993
2021-07-02 01:45:00,33261.3,2021-07-02 07:30:00,33167.5,93.8,261893.84999999992,161893.84999999992
2021-07-02 07:45:00,33340.17,2021-07-02 09:00:00,33270.71,-69.46,261824.38999999993,161824.38999999993
2021-07-02 09:15:00,32958.42,2021-07-02 13:30:00,33306.5,-348.08,261476.30999999994,161476.30999999994
2021-07-02 13:45:00,33451.7,2021-07-02 18:45:00,33275.36,-176.34,261299.96999999994,161299.96999999994
2021-07-02 19:00:00,33149.5,2021-07-02 22:15:00,33465.0,-315.5,260984.46999999994,160984.46999999994
2021-07-02 22:30:00,33529.79,2021-07-03 02:45:00,33506.9,-22.89,260961.57999999993,160961.57999999993
2021-07-03 03:00:00,33407.78,2021-07-03 05:45:00,33683.02,-275.24,260686.33999999994,160686.33999999994
2021-07-03 06:00:00,33726.43,2021-07-03 17:30:00,34928.42,1201.99,261888.32999999993,161888.32999999993
2021-07-03 21:45:00,34533.19,2021-07-04 03:00:00,34629.43,-96.24,261792.08999999994,161792.08999999994
2021-07-04 03:15:00,34680.0,2021-07-04 12:30:00,35442.15,762.15,262554.23999999993,162554.23999999993
2021-07-04 12:45:00,35239.4,2021-07-04 16:00:00,35517.56,-278.16,262276.07999999996,162276.07999999993
2021-07-04 16:15:00,35637.62,2021-07-04 22:30:00,35594.88,-42.74,262233.33999999997,162233.33999999994
2021-07-04 22:45:00,35357.23,2021-07-05 10:15:00,34389.12,968.11,263201.44999999995,163201.44999999992
2021-07-05 10:30:00,34464.45,2021-07-05 11:00:00,34229.21,-235.24,262966.20999999996,162966.20999999993
2021-07-05 11:15:00,33733.58,2021-07-05 17:30:00,33172.26,561.32,263527.5299999999,163527.52999999994
2021-07-05 17:45:00,33680.02,2021-07-05 23:30:00,33831.29,151.27,263678.79999999993,163678.79999999993
2021-07-05 23:45:00,33672.72,2021-07-06 03:45:00,33896.83,-224.11,263454.68999999994,163454.68999999994
2021-07-06 04:00:00,34486.0,2021-07-06 08:45:00,34959.09,473.09,263927.7799999999,163927.77999999994
2021-07-06 09:00:00,34476.26,2021-07-06 23:00:00,34047.22,429.04,264356.81999999995,164356.81999999995
2021-07-06 23:15:00,34068.23,2021-07-07 14:15:00,34706.6,638.37,264995.18999999994,164995.18999999994
2021-07-07 14:30:00,34568.51,2021-07-08 05:15:00,33179.0,1389.51,266384.69999999995,166384.69999999995
2021-07-08 06:00:00,33345.0,2021-07-08 07:15:00,33033.69,-311.31,266073.38999999996,166073.38999999996
2021-07-08 07:30:00,32547.13,2021-07-08 12:15:00,32647.02,-99.89,265973.49999999994,165973.49999999994
2021-07-08 12:30:00,32786.0,2021-07-08 21:30:00,32882.61,96.61,266070.1099999999,166070.10999999993
2021-07-08 21:45:00,32685.0,2021-07-09 02:15:00,32825.01,-140.01,265930.0999999999,165930.09999999992
2021-07-09 02:30:00,32820.92,2021-07-09 06:45:00,32850.0,29.08,265959.17999999993,165959.1799999999
2021-07-09 07:00:00,32772.75,2021-07-09 12:45:00,32969.49,-196.74,265762.43999999994,165762.43999999992
2021-07-09 13:00:00,33180.01,2021-07-10 01:30:00,33902.01,722.0,266484.43999999994,166484.43999999992
2021-07-10 01:45:00,33756.38,2021-07-10 08:00:00,33768.31,-11.93,266472.5099999999,166472.50999999992
2021-07-10 08:15:00,33807.95,2021-07-10 16:45:00,34014.28,206.33,266678.8399999999,166678.8399999999
2021-07-10 17:00:00,33678.88,2021-07-10 21:30:00,33354.99,323.89,267002.7299999999,167002.72999999992
2021-07-10 21:45:00,33408.21,2021-07-11 03:30:00,33456.31,48.1,267050.82999999996,167050.82999999993
2021-07-11 03:45:00,33446.92,2021-07-11 08:00:00,33489.94,-43.02,267007.80999999994,167007.80999999994
2021-07-11 08:15:00,33667.3,2021-07-11 23:45:00,34253.81,586.51,267594.31999999995,167594.31999999995
2021-07-12 00:00:00,34134.26,2021-07-12 03:00:00,34305.04,-170.78,267423.5399999999,167423.53999999995
2021-07-12 03:15:00,34463.34,2021-07-12 04:45:00,34284.59,-178.75,267244.7899999999,167244.78999999995
2021-07-12 05:00:00,34233.82,2021-07-12 18:45:00,32873.07,1360.75,268605.5399999999,168605.53999999995
2021-07-12 23:30:00,33125.01,2021-07-13 04:45:00,33110.66,-14.35,268591.18999999994,168591.18999999994
2021-07-13 05:00:00,32898.01,2021-07-13 06:45:00,32958.7,-60.69,268530.49999999994,168530.49999999994
2021-07-13 07:00:00,33211.83,2021-07-13 12:00:00,32960.01,-251.82,268278.67999999993,168278.67999999993
2021-07-13 12:15:00,32881.93,2021-07-13 15:30:00,32662.44,219.49,268498.1699999999,168498.16999999993
2021-07-13 15:45:00,32781.41,2021-07-13 18:30:00,32554.21,-227.2,268270.9699999999,168270.9699999999
2021-07-13 18:45:00,32475.58,2021-07-13 23:00:00,32594.66,-119.08,268151.8899999999,168151.88999999993
2021-07-13 23:15:00,32679.95,2021-07-14 00:45:00,32420.02,-259.93,267891.95999999996,167891.95999999993
2021-07-14 01:00:00,32267.0,2021-07-14 09:00:00,32190.12,76.88,267968.83999999997,167968.83999999994
2021-07-14 09:15:00,32334.21,2021-07-14 18:45:00,32731.01,396.8,268365.6399999999,168365.63999999993
2021-07-14 19:00:00,32650.29,2021-07-14 22:15:00,32870.01,-219.72,268145.9199999999,168145.91999999993
2021-07-14 22:30:00,32973.23,2021-07-15 02:45:00,32753.34,-219.89,267926.0299999999,167926.0299999999
2021-07-15 03:00:00,32666.25,2021-07-15 20:00:00,31613.86,1052.39,268978.4199999999,168978.41999999993
2021-07-15 20:15:00,31682.91,2021-07-16 06:00:00,31741.0,58.09,269036.5099999999,169036.50999999992
2021-07-16 06:15:00,31661.64,2021-07-16 12:30:00,31222.72,438.92,269475.42999999993,169475.42999999993
2021-07-16 12:45:00,31699.99,2021-07-16 20:30:00,31893.51,193.52,269668.94999999995,169668.94999999992
2021-07-16 20:45:00,31814.0,2021-07-17 06:30:00,31508.01,305.99,269974.93999999994,169974.93999999992
2021-07-17 06:45:00,31556.77,2021-07-17 09:45:00,31589.67,32.9,270007.8399999999,170007.8399999999
2021-07-17 10:00:00,31246.45,2021-07-17 13:45:00,31607.99,-472.83,269535.0099999999,169535.00999999992
2021-07-17 14:30:00,31705.0,2021-07-17 22:45:00,31629.47,-75.53,269459.4799999999,169459.47999999992
2021-07-17 23:00:00,31569.99,2021-07-18 00:30:00,31777.5,-207.51,269251.9699999999,169251.9699999999
2021-07-18 00:45:00,31957.83,2021-07-18 04:15:00,32110.68,152.85,269404.81999999995,169404.81999999992
2021-07-18 04:30:00,32066.14,2021-07-18 16:30:00,31405.91,660.23,270065.04999999993,170065.04999999993
2021-07-18 16:45:00,31447.33,2021-07-18 22:15:00,31576.25,128.92,270193.97,170193.96999999994
2021-07-18 22:30:00,31514.31,2021-07-19 05:30:00,31681.62,-167.31,270026.6599999999,170026.65999999995
2021-07-19 05:45:00,31776.08,2021-07-19 08:15:00,31614.0,-162.08,269864.57999999996,169864.57999999996
2021-07-19 08:30:00,31555.93,2021-07-19 20:15:00,30680.24,875.69,270740.26999999996,170740.26999999996
2021-07-19 20:30:00,30773.85,2021-07-20 00:45:00,30788.03,14.18,270754.44999999995,170754.44999999995
2021-07-20 01:00:00,30578.56,2021-07-20 11:45:00,29673.33,905.23,271659.67999999993,171659.67999999996
2021-07-20 12:00:00,29703.24,2021-07-20 22:15:00,29650.0,-53.24,271606.43999999994,171606.43999999997
2021-07-20 22:30:00,29573.03,2021-07-21 03:15:00,29810.64,-237.61,271368.82999999996,171368.83
2021-07-21 03:30:00,29839.32,2021-07-21 09:45:00,31259.55,1420.23,272789.06,172789.06
2021-07-21 18:45:00,31757.9,2021-07-21 23:15:00,32028.04,-270.14,272518.92,172518.91999999998
2021-07-21 23:30:00,32135.73,2021-07-22 05:30:00,31930.93,-204.8,272314.12,172314.12
2021-07-22 05:45:00,31883.31,2021-07-22 12:45:00,32181.04,-297.73,272016.39,172016.38999999998
2021-07-22 13:00:00,32188.13,2021-07-22 20:30:00,32291.54,103.41,272119.8,172119.8
2021-07-22 20:45:00,32218.0,2021-07-23 01:15:00,32355.09,-137.09,271982.70999999996,171982.71
2021-07-23 01:30:00,32635.04,2021-07-23 05:45:00,32601.47,-33.57,271949.14,171949.13999999998
2021-07-23 06:00:00,32514.01,2021-07-23 19:45:00,32221.12,292.89,272242.03,172242.03
2021-07-23 20:00:00,32394.26,2021-07-24 04:00:00,33682.72,1288.46,273530.49,173530.49
2021-07-24 14:00:00,33729.99,2021-07-24 16:00:00,33868.0,-138.01,273392.48,173392.47999999998
2021-07-24 16:15:00,34182.5,2021-07-24 19:15:00,34094.63,-87.87,273304.61,173304.61
2021-07-24 19:30:00,33979.39,2021-07-24 23:15:00,34019.99,-40.6,273264.01,173264.00999999998
2021-07-24 23:30:00,34111.68,2021-07-25 01:30:00,34001.31,-110.37,273153.64,173153.63999999998
2021-07-25 01:45:00,33898.97,2021-07-25 02:45:00,34158.99,-260.02,272893.62,172893.62
2021-07-25 03:00:00,34278.79,2021-07-25 10:30:00,34360.0,81.21,272974.82999999996,172974.83
2021-07-25 10:45:00,34328.32,2021-07-25 17:00:00,34250.81,77.51,273052.33999999997,173052.34
2021-07-25 17:15:00,34417.01,2021-07-26 01:00:00,44200.69,9783.68,282836.02,182836.02
2021-07-26 01:15:00,37973.99,2021-07-26 06:00:00,38630.34,-656.35,282179.67,182179.66999999998
2021-07-26 06:15:00,39065.08,2021-07-26 10:00:00,38264.35,-800.73,281378.93999999994,181378.93999999997
2021-07-26 10:15:00,38179.99,2021-07-26 15:45:00,38537.0,-357.01,281021.92999999993,181021.92999999996
2021-07-26 16:00:00,38821.13,2021-07-26 19:45:00,39358.4,537.27,281559.19999999995,181559.19999999995
2021-07-26 20:00:00,38234.43,2021-07-27 07:45:00,37103.66,1130.77,282689.97,182689.96999999994
2021-07-27 08:00:00,37214.98,2021-07-27 13:45:00,38438.44,1223.46,283913.42999999993,183913.42999999993
2021-07-27 14:00:00,37745.82,2021-07-27 20:45:00,38017.58,-271.76,283641.6699999999,183641.66999999993
2021-07-27 21:00:00,38213.56,2021-07-28 06:15:00,39721.5,1507.94,285149.6099999999,185149.60999999993
2021-07-28 06:30:00,39313.28,2021-07-28 09:45:00,39933.54,-620.26,284529.3499999999,184529.34999999992
2021-07-28 10:00:00,40176.59,2021-07-28 12:30:00,39972.98,-203.61,284325.73999999993,184325.73999999993
2021-07-28 12:45:00,39669.85,2021-07-28 18:15:00,39526.81,143.04,284468.7799999999,184468.77999999994
2021-07-28 18:30:00,40252.01,2021-07-29 00:30:00,39707.99,-544.02,283924.75999999995,183924.75999999995
2021-07-29 00:45:00,39388.44,2021-07-29 05:15:00,39758.96,-370.52,283554.24,183554.23999999996
2021-07-29 05:30:00,40095.97,2021-07-29 11:15:00,40165.35,69.38,283623.62,183623.61999999997
2021-07-29 11:30:00,39676.99,2021-07-29 22:45:00,39773.85,-96.86,283526.76,183526.75999999998
2021-07-29 23:00:00,39883.44,2021-07-30 04:00:00,39927.41,43.97,283570.73,183570.72999999998
2021-07-30 04:15:00,39881.35,2021-07-30 13:45:00,38810.97,1070.38,284641.11,184641.11
2021-07-30 14:00:00,39045.95,2021-07-30 20:45:00,41727.0,2681.05,287322.16,187322.15999999997
2021-07-30 21:15:00,40886.0,2021-07-30 23:15:00,41415.12,-529.12,286793.04,186793.03999999998
2021-07-30 23:30:00,41877.19,2021-07-31 04:45:00,41829.94,-47.25,286745.79,186745.78999999998
2021-07-31 05:00:00,41702.42,2021-07-31 10:15:00,41764.11,-61.69,286684.1,186684.09999999998
2021-07-31 10:30:00,41894.29,2021-07-31 13:30:00,41550.0,-611.52,286072.57999999996,186072.58
2021-07-31 16:45:00,41284.09,2021-07-31 20:15:00,41385.49,-101.4,285971.18,185971.18
2021-07-31 20:30:00,41681.3,2021-08-01 04:45:00,42062.28,380.98,286352.16000000003,186352.16
2021-08-01 05:00:00,41747.0,2021-08-01 19:15:00,41203.89,543.11,286895.27,186895.27
2021-08-01 19:30:00,41414.31,2021-08-01 22:00:00,41109.71,-304.6,286590.67,186590.66999999998
2021-08-01 22:15:00,40583.6,2021-08-02 06:15:00,39699.99,883.61,287474.27999999997,187474.27999999997
2021-08-02 06:30:00,40035.0,2021-08-02 08:00:00,39975.95,-59.05,287415.23,187415.22999999998
2021-08-02 08:15:00,39658.93,2021-08-02 13:45:00,39557.43,101.5,287516.73,187516.72999999998
2021-08-02 14:00:00,39573.03,2021-08-02 19:15:00,39520.86,-52.17,287464.55999999994,187464.55999999997
2021-08-02 19:30:00,39332.93,2021-08-02 22:30:00,39369.38,-36.45,287428.11,187428.10999999996
2021-08-02 22:45:00,39410.01,2021-08-03 01:30:00,39034.99,-375.02,287053.08999999997,187053.08999999997
2021-08-03 01:45:00,38821.24,2021-08-03 08:00:00,38413.8,407.44,287460.52999999997,187460.52999999997
2021-08-03 08:15:00,38621.29,2021-08-03 12:00:00,38400.0,-725.03,286735.5,186735.49999999997
2021-08-03 15:15:00,38058.27,2021-08-03 21:30:00,38222.41,-164.14,286571.36,186571.35999999996
2021-08-03 21:45:00,38330.54,2021-08-04 03:00:00,38068.15,-262.39,286308.97,186308.96999999994
2021-08-04 03:15:00,37928.7,2021-08-04 10:30:00,37894.84,33.86,286342.82999999996,186342.82999999993
2021-08-04 10:45:00,38080.99,2021-08-04 21:00:00,39845.01,1764.02,288106.8499999999,188106.84999999992
2021-08-05 01:15:00,39248.0,2021-08-05 13:45:00,38038.16,1209.84,289316.68999999994,189316.68999999992
2021-08-05 14:00:00,38383.48,2021-08-05 23:00:00,41015.58,2632.1,291948.7899999999,191948.78999999992
2021-08-06 00:45:00,40079.88,2021-08-06 05:45:00,40549.35,-469.47,291479.31999999995,191479.31999999992
2021-08-06 06:00:00,40709.43,2021-08-06 21:30:00,42618.93,1909.5,293388.81999999995,193388.81999999992
2021-08-06 21:45:00,42434.21,2021-08-07 00:30:00,42931.12,-496.91,292891.9099999999,192891.90999999992
2021-08-07 00:45:00,43258.02,2021-08-07 06:15:00,43363.44,105.42,292997.32999999996,192997.32999999993
2021-08-07 06:30:00,43177.22,2021-08-07 09:45:00,43629.99,-452.77,292544.55999999994,192544.55999999994
2021-08-07 10:00:00,43778.4,2021-08-07 12:30:00,43839.83,61.43,292605.98999999993,192605.98999999993
2021-08-07 12:45:00,43546.05,2021-08-07 16:30:00,43425.72,120.33,292726.31999999995,192726.31999999992
2021-08-07 16:45:00,43706.59,2021-08-08 10:00:00,44632.93,926.34,293652.6599999999,193652.65999999992
2021-08-08 10:15:00,44345.55,2021-08-08 21:30:00,44181.59,163.96,293816.6199999999,193816.6199999999
2021-08-08 21:45:00,44210.0,2021-08-08 23:45:00,43787.71,-422.29,293394.3299999999,193394.3299999999
2021-08-09 00:00:00,43336.57,2021-08-09 04:30:00,43554.98,-218.41,293175.9199999999,193175.9199999999
2021-08-09 04:45:00,43574.41,2021-08-09 18:00:00,45912.1,2337.69,295513.60999999987,195513.6099999999
2021-08-09 20:45:00,45484.57,2021-08-09 22:30:00,46015.88,-531.31,294982.29999999993,194982.2999999999
2021-08-09 22:45:00,46258.3,2021-08-10 03:00:00,45946.06,-312.24,294670.05999999994,194670.0599999999
2021-08-10 03:15:00,45778.68,2021-08-10 08:30:00,46040.45,-261.77,294408.2899999999,194408.28999999992
2021-08-10 08:45:00,46151.28,2021-08-10 10:30:00,45484.44,-770.03,293638.2599999999,193638.25999999992
2021-08-10 10:45:00,45375.91,2021-08-10 19:15:00,45414.31,-38.4,293599.8599999999,193599.85999999993
2021-08-10 19:30:00,45512.01,2021-08-11 11:30:00,46067.88,555.87,294155.7299999999,194155.72999999992
2021-08-11 11:45:00,45946.21,2021-08-11 14:15:00,46376.06,-429.85,293725.8799999999,193725.87999999992
2021-08-11 14:30:00,46540.05,2021-08-11 20:45:00,46323.1,-216.95,293508.92999999993,193508.9299999999
2021-08-11 21:00:00,46098.99,2021-08-12 02:00:00,46002.99,96.0,293604.92999999993,193604.9299999999
2021-08-12 02:15:00,46076.2,2021-08-12 04:30:00,45739.69,-336.51,293268.4199999999,193268.4199999999
2021-08-12 04:45:00,45593.3,2021-08-12 19:45:00,44370.26,1223.04,294491.4599999999,194491.4599999999
2021-08-12 20:00:00,44533.25,2021-08-12 22:45:00,43970.0,-609.23,293882.22999999986,193882.2299999999
2021-08-14 03:30:00,47464.95,2021-08-14 09:15:00,47779.51,-314.56,293567.6699999999,193567.6699999999
2021-08-14 09:30:00,48050.63,2021-08-14 09:30:00,48050.63,0.0,293567.6699999999,193567.6699999999
2021-08-14 09:45:00,47035.91,2021-08-14 09:45:00,47035.91,-741.42,292826.2499999999,192826.24999999988
2021-08-14 14:15:00,46768.95,2021-08-14 19:45:00,47044.67,275.72,293101.96999999986,193101.96999999988
2021-08-14 20:00:00,46650.57,2021-08-14 21:30:00,46921.38,-270.81,292831.1599999999,192831.1599999999
2021-08-14 21:45:00,47029.11,2021-08-15 03:45:00,46900.01,-129.1,292702.0599999999,192702.05999999988
2021-08-15 04:00:00,46572.9,2021-08-15 13:45:00,46055.65,517.25,293219.3099999999,193219.30999999988
2021-08-15 14:00:00,46348.21,2021-08-15 16:45:00,45898.61,-449.6,292769.70999999985,192769.70999999988
2021-08-15 17:00:00,45729.99,2021-08-15 19:45:00,46335.28,-686.47,292083.2399999999,192083.23999999987
2021-08-15 20:00:00,46385.01,2021-08-16 06:00:00,47467.58,1082.57,293165.8099999999,193165.80999999988
2021-08-16 06:15:00,47230.01,2021-08-17 01:00:00,45986.77,1243.24,294409.0499999999,194409.04999999987
2021-08-17 01:15:00,46292.13,2021-08-17 05:45:00,46063.65,-228.48,294180.56999999983,194180.56999999986
2021-08-17 06:00:00,45904.07,2021-08-17 09:00:00,46329.02,-424.95,293755.6199999999,193755.61999999985
2021-08-17 09:15:00,46519.12,2021-08-17 13:45:00,46396.71,-122.41,293633.20999999985,193633.20999999985
2021-08-17 14:00:00,46169.48,2021-08-18 03:45:00,45083.38,1086.1,294719.3099999998,194719.30999999985
2021-08-18 04:00:00,45193.01,2021-08-18 11:15:00,45065.65,-127.36,294591.94999999984,194591.94999999987
2021-08-18 11:30:00,44843.15,2021-08-18 14:30:00,45309.84,-466.69,294125.2599999999,194125.25999999986
2021-08-18 14:45:00,45419.98,2021-08-18 18:45:00,45422.48,2.5,294127.7599999999,194127.75999999986
2021-08-18 19:00:00,45336.49,2021-08-18 23:00:00,44963.0,373.49,294501.2499999999,194501.24999999985
2021-08-18 23:15:00,45079.66,2021-08-19 02:45:00,44599.84,-479.82,294021.4299999998,194021.42999999985
2021-08-19 03:00:00,44303.13,2021-08-19 07:30:00,44366.54,-63.41,293958.01999999984,193958.01999999984
2021-08-19 07:45:00,44684.87,2021-08-19 11:15:00,44382.79,-302.08,293655.9399999998,193655.93999999986
2021-08-19 11:30:00,44294.54,2021-08-19 13:30:00,44805.65,-511.11,293144.82999999984,193144.82999999987
2021-08-19 13:45:00,44987.9,2021-08-20 00:15:00,47433.93,2446.03,295590.85999999987,195590.85999999987
2021-08-20 07:45:00,46871.29,2021-08-20 13:00:00,47200.01,-328.72,295262.1399999999,195262.13999999987
2021-08-20 13:15:00,47483.63,2021-08-20 18:45:00,48482.83,999.2,296261.33999999985,196261.33999999988
2021-08-20 19:00:00,48459.05,2021-08-20 21:30:00,48919.99,-460.94,295800.3999999999,195800.39999999988
2021-08-20 21:45:00,49378.76,2021-08-21 02:45:00,48877.78,-500.98,295299.41999999987,195299.41999999987
2021-08-21 03:00:00,48835.59,2021-08-21 10:30:00,48945.78,-110.19,295189.22999999986,195189.22999999986
2021-08-21 10:45:00,49311.04,2021-08-21 11:00:00,48496.7,-734.03,294455.19999999984,194455.19999999987
2021-08-21 11:15:00,48379.93,2021-08-21 12:30:00,48722.37,-342.44,294112.7599999999,194112.75999999986
2021-08-21 12:45:00,49245.22,2021-08-21 19:15:00,49155.37,-89.85,294022.90999999986,194022.90999999986
2021-08-21 19:30:00,48964.19,2021-08-22 05:30:00,49113.36,-149.17,293873.7399999999,193873.73999999985
2021-08-22 05:45:00,49153.8,2021-08-22 12:00:00,49037.48,-116.32,293757.4199999998,193757.41999999984
2021-08-22 12:15:00,49000.01,2021-08-22 16:15:00,48717.64,282.37,294039.7899999998,194039.78999999983
2021-08-22 16:30:00,48759.97,2021-08-23 08:45:00,50263.35,1503.38,295543.1699999998,195543.16999999984
2021-08-23 14:30:00,49867.64,2021-08-23 21:45:00,49601.6,266.04,295809.20999999985,195809.20999999985
2021-08-23 22:00:00,49696.65,2021-08-24 00:45:00,49272.89,-593.33,295215.8799999999,195215.87999999986
2021-08-24 01:00:00,48988.46,2021-08-24 03:15:00,49294.02,-305.56,294910.31999999983,194910.31999999986
2021-08-24 03:30:00,49338.77,2021-08-24 10:30:00,49435.57,96.8,295007.1199999999,195007.11999999985
2021-08-24 10:45:00,49330.78,2021-08-25 02:15:00,48124.83,1205.95,296213.06999999983,196213.06999999986
2021-08-25 02:30:00,48267.38,2021-08-25 07:45:00,48159.67,-107.71,296105.35999999987,196105.35999999987
2021-08-25 08:00:00,47995.57,2021-08-25 12:30:00,47637.65,357.92,296463.2799999999,196463.27999999988
2021-08-25 12:45:00,47772.8,2021-08-26 02:15:00,48840.01,1067.21,297530.4899999999,197530.48999999987
2021-08-26 02:30:00,48746.44,2021-08-26 12:00:00,46367.97,2378.47,299908.95999999985,199908.95999999988
2021-08-26 12:15:00,47393.77,2021-08-26 16:15:00,46734.61,-852.0,299056.95999999985,199056.95999999988
2021-08-27 00:00:00,46634.09,2021-08-27 00:30:00,46762.61,-128.52,298928.4399999999,198928.4399999999
2021-08-27 00:45:00,47278.4,2021-08-27 03:00:00,47094.78,-183.62,298744.8199999999,198744.8199999999
2021-08-27 03:15:00,46790.0,2021-08-27 07:30:00,47313.64,-523.64,298221.1799999999,198221.17999999988
2021-08-27 07:45:00,47483.55,2021-08-27 13:00:00,47160.12,-323.43,297897.7499999999,197897.74999999988
2021-08-27 13:15:00,47149.59,2021-08-27 14:00:00,47707.26,-557.67,297340.07999999984,197340.07999999987
2021-08-27 14:15:00,47963.03,2021-08-28 05:30:00,48926.71,963.68,298303.7599999999,198303.75999999986
2021-08-28 05:45:00,48907.01,2021-08-28 15:45:00,48840.0,67.01,298370.7699999999,198370.76999999987
2021-08-28 16:00:00,48925.69,2021-08-28 18:45:00,48815.84,-109.85,298260.91999999987,198260.91999999987
2021-08-28 19:00:00,48676.74,2021-08-28 21:30:00,48914.85,-238.11,298022.8099999999,198022.80999999988
2021-08-28 21:45:00,48959.19,2021-08-29 02:15:00,49281.5,322.31,298345.1199999999,198345.11999999988
2021-08-29 02:30:00,49041.38,2021-08-29 06:00:00,48361.76,679.62,299024.7399999999,199024.73999999987
2021-08-29 06:15:00,48419.55,2021-08-29 23:30:00,48886.08,466.53,299491.2699999999,199491.26999999987
2021-08-29 23:45:00,48795.41,2021-08-30 08:15:00,48070.01,725.4,300216.66999999987,200216.66999999987
2021-08-30 08:30:00,48218.12,2021-08-30 11:30:00,47966.93,-525.53,299691.1399999999,199691.13999999987
2021-08-30 12:15:00,47603.22,2021-08-30 15:15:00,47909.61,-306.39,299384.7499999999,199384.74999999985
2021-08-30 15:30:00,48010.62,2021-08-30 22:00:00,48220.55,209.93,299594.6799999998,199594.67999999985
2021-08-30 22:15:00,47849.72,2021-08-31 05:45:00,47176.68,673.04,300267.71999999986,200267.71999999986
2021-08-31 06:00:00,47197.83,2021-08-31 09:45:00,47429.21,231.38,300499.09999999986,200499.09999999986
2021-08-31 10:00:00,47277.97,2021-08-31 11:15:00,47799.0,-521.03,299978.06999999983,199978.06999999986
2021-08-31 11:30:00,48038.22,2021-08-31 14:30:00,47576.34,-461.88,299516.1899999998,199516.18999999986
2021-08-31 14:45:00,47298.48,2021-09-01 03:45:00,47086.61,211.87,299728.0599999998,199728.05999999985
2021-09-01 04:00:00,47281.99,2021-09-01 14:30:00,47478.8,196.81,299924.8699999999,199924.86999999985
2021-09-01 14:45:00,47320.78,2021-09-01 16:15:00,47494.42,-173.64,299751.22999999986,199751.22999999984
2021-09-01 16:30:00,48299.77,2021-09-01 16:30:00,48299.77,-662.76,299088.46999999986,199088.46999999983
2021-09-01 19:30:00,48221.01,2021-09-01 21:45:00,48462.99,-241.98,298846.4899999998,198846.48999999982
2021-09-01 22:00:00,48769.44,2021-09-02 14:15:00,50046.55,1277.11,300123.5999999998,200123.5999999998
2021-09-02 14:30:00,49612.19,2021-09-02 21:30:00,49723.01,-110.82,300012.7799999998,200012.7799999998
2021-09-02 21:45:00,49854.54,2021-09-02 23:00:00,49587.7,-266.84,299745.9399999998,199745.9399999998
2021-09-02 23:15:00,49341.85,2021-09-03 02:30:00,48918.26,423.59,300169.5299999998,200169.5299999998
2021-09-03 02:45:00,49008.68,2021-09-03 10:45:00,49903.84,895.16,301064.6899999998,201064.6899999998
2021-09-03 11:00:00,49743.81,2021-09-03 12:15:00,50125.8,-381.99,300682.69999999984,200682.6999999998
2021-09-03 12:30:00,50732.86,2021-09-03 17:45:00,50456.34,-276.52,300406.1799999998,200406.17999999982
2021-09-03 18:00:00,50413.83,2021-09-04 03:15:00,50079.12,334.71,300740.8899999998,200740.8899999998
2021-09-04 03:30:00,50352.0,2021-09-04 10:30:00,50282.38,-69.62,300671.2699999998,200671.26999999981
2021-09-04 10:45:00,49816.29,2021-09-04 18:15:00,49929.94,-113.65,300557.6199999998,200557.61999999982
2021-09-04 18:30:00,49941.83,2021-09-05 03:15:00,49827.91,-113.92,300443.69999999984,200443.6999999998
2021-09-05 03:30:00,49807.67,2021-09-05 06:45:00,49874.25,-66.58,300377.1199999998,200377.11999999982
2021-09-05 07:00:00,50001.58,2021-09-05 22:45:00,51873.4,1871.82,302248.9399999998,202248.93999999983
2021-09-06 11:30:00,51511.38,2021-09-06 13:45:00,51500.01,11.37,302260.3099999998,202260.30999999982
2021-09-06 14:00:00,51685.93,2021-09-07 06:30:00,52589.46,903.53,303163.83999999985,203163.83999999982
2021-09-07 06:45:00,52380.91,2021-09-07 14:45:00,47539.53,4841.38,308005.21999999986,208005.21999999983
2021-09-07 15:15:00,46528.42,2021-09-08 03:00:00,46853.83,325.41,308330.62999999983,208330.62999999983
2021-09-08 03:15:00,46344.75,2021-09-08 08:30:00,45723.03,621.72,308952.34999999986,208952.34999999983
2021-09-08 08:45:00,45988.0,2021-09-08 19:45:00,46454.12,466.12,309418.46999999986,209418.46999999983
2021-09-08 20:00:00,45938.15,2021-09-08 22:00:00,46325.64,-387.49,309030.97999999986,209030.97999999984
2021-09-08 22:15:00,46700.63,2021-09-09 00:00:00,46015.0,-811.14,308219.83999999985,208219.83999999982
2021-09-09 00:15:00,45975.3,2021-09-09 05:15:00,46208.73,-233.43,307986.4099999998,207986.40999999983
2021-09-09 05:30:00,46266.45,2021-09-09 12:15:00,46050.01,-216.44,307769.96999999986,207769.96999999983
2021-09-09 12:30:00,45756.71,2021-09-09 12:30:00,45756.71,0.0,307769.96999999986,207769.96999999983
2021-09-09 12:45:00,46681.95,2021-09-09 12:45:00,46681.95,-854.35,306915.6199999998,206915.61999999982
2021-09-09 18:00:00,46673.21,2021-09-10 01:00:00,46590.0,83.21,306998.82999999984,206998.8299999998
2021-09-10 01:15:00,46776.0,2021-09-10 06:30:00,46485.0,-291.0,306707.82999999984,206707.8299999998
2021-09-10 06:45:00,46413.0,2021-09-10 10:15:00,46185.38,227.62,306935.44999999984,206935.4499999998
2021-09-10 10:30:00,46376.73,2021-09-10 14:00:00,45737.99,-892.44,306043.0099999998,206043.0099999998
2021-09-10 14:15:00,45341.88,2021-09-10 17:00:00,45487.64,-145.76,305897.24999999977,205897.2499999998
2021-09-10 17:15:00,45684.41,2021-09-10 20:30:00,45267.84,-416.57,305480.6799999998,205480.6799999998
2021-09-10 20:45:00,45086.62,2021-09-10 23:45:00,44860.83,225.79,305706.4699999998,205706.4699999998
2021-09-11 00:00:00,45118.26,2021-09-11 07:15:00,44980.02,-138.24,305568.2299999998,205568.2299999998
2021-09-11 07:30:00,44885.82,2021-09-11 09:30:00,45191.2,-305.38,305262.8499999998,205262.8499999998
2021-09-11 09:45:00,45482.24,2021-09-11 18:15:00,45610.39,128.15,305390.99999999977,205390.9999999998
2021-09-11 18:30:00,45559.27,2021-09-12 02:30:00,45263.05,296.22,305687.2199999998,205687.2199999998
2021-09-12 02:45:00,45311.8,2021-09-12 18:15:00,45891.15,579.35,306266.56999999983,206266.5699999998
2021-09-12 18:30:00,45870.96,2021-09-12 22:30:00,45480.87,390.09,306656.6599999998,206656.6599999998
2021-09-12 22:45:00,45790.52,2021-09-13 00:45:00,46062.41,271.89,306928.5499999998,206928.5499999998
2021-09-13 01:00:00,45451.16,2021-09-13 13:15:00,44725.01,726.15,307654.69999999984,207654.6999999998
2021-09-13 13:30:00,46317.8,2021-09-13 13:30:00,46317.8,-1053.43,306601.2699999998,206601.26999999981
2021-09-13 14:00:00,44280.0,2021-09-13 14:00:00,44280.0,-1552.35,305048.9199999998,205048.9199999998
2021-09-13 17:30:00,44461.66,2021-09-14 10:45:00,46073.92,1612.26,306661.1799999998,206661.17999999982
2021-09-15 04:45:00,46867.82,2021-09-15 07:45:00,47166.3,-298.48,306362.69999999984,206362.6999999998
2021-09-15 08:00:00,47295.69,2021-09-16 00:15:00,48005.95,710.26,307072.95999999985,207072.95999999982
2021-09-16 00:30:00,47881.31,2021-09-16 03:45:00,47614.56,266.75,307339.70999999985,207339.70999999982
2021-09-16 04:00:00,47982.71,2021-09-16 09:30:00,48134.87,152.16,307491.8699999998,207491.86999999982
2021-09-16 09:45:00,47901.89,2021-09-16 15:00:00,47645.09,256.8,307748.6699999998,207748.6699999998
2021-09-16 15:15:00,48077.9,2021-09-16 17:30:00,47616.45,-461.45,307287.2199999998,207287.2199999998
2021-09-16 17:45:00,47402.91,2021-09-16 22:30:00,47593.18,-190.27,307096.94999999984,207096.9499999998
2021-09-16 22:45:00,47643.48,2021-09-17 10:00:00,47653.99,10.51,307107.45999999985,207107.45999999982
2021-09-17 10:15:00,47589.14,2021-09-17 19:15:00,47282.47,306.67,307414.12999999983,207414.12999999983
2021-09-17 19:30:00,47328.06,2021-09-17 20:30:00,47188.18,-139.88,307274.2499999998,207274.24999999983
2021-09-17 20:45:00,46977.25,2021-09-18 00:45:00,47391.89,-414.64,306859.6099999998,206859.6099999998
2021-09-18 01:00:00,47533.99,2021-09-18 11:30:00,48596.96,1062.97,307922.57999999984,207922.5799999998
2021-09-18 11:45:00,48383.15,2021-09-19 06:15:00,47949.06,434.09,308356.6699999998,208356.6699999998
2021-09-19 06:30:00,48010.01,2021-09-19 10:45:00,48077.69,67.68,308424.3499999998,208424.3499999998
2021-09-19 11:00:00,47907.89,2021-09-19 14:15:00,47455.7,452.19,308876.5399999998,208876.5399999998
2021-09-19 14:30:00,47604.53,2021-09-19 22:15:00,47245.39,-559.32,308317.2199999998,208317.2199999998
2021-09-19 22:30:00,47080.0,2021-09-20 07:30:00,44417.96,2662.04,310979.2599999998,210979.2599999998
2021-09-20 13:45:00,44037.11,2021-09-20 19:00:00,43232.58,-804.53,310174.7299999998,210174.7299999998
2021-09-20 19:15:00,43083.81,2021-09-21 01:00:00,41631.41,1452.4,311627.1299999998,211627.1299999998
2021-09-21 01:15:00,42215.69,2021-09-21 13:45:00,43122.12,906.43,312533.5599999998,212533.5599999998
2021-09-21 14:00:00,42589.99,2021-09-21 21:15:00,40956.93,1633.06,314166.61999999976,214166.6199999998
2021-09-21 21:30:00,41752.84,2021-09-22 11:15:00,42006.17,253.33,314419.9499999998,214419.94999999978
2021-09-22 11:30:00,41856.27,2021-09-22 13:00:00,42435.34,-754.4,313665.5499999998,213665.54999999978
2021-09-22 15:15:00,42781.99,2021-09-23 00:30:00,43259.36,477.37,314142.9199999998,214142.91999999978
2021-09-23 00:45:00,43179.34,2021-09-23 03:00:00,43672.62,-493.28,313649.6399999998,213649.63999999978
2021-09-23 03:15:00,44140.48,2021-09-23 10:00:00,43719.83,-420.65,313228.98999999976,213228.9899999998
2021-09-23 10:15:00,43551.88,2021-09-23 14:30:00,44086.39,-534.51,312694.47999999975,212694.47999999978
2021-09-23 14:45:00,44123.58,2021-09-24 03:30:00,44433.45,309.87,313004.34999999974,213004.34999999977
2021-09-24 03:45:00,44270.3,2021-09-24 06:45:00,44091.78,178.52,313182.86999999976,213182.86999999976
2021-09-24 07:00:00,44588.51,2021-09-24 08:45:00,44500.0,-88.51,313094.35999999975,213094.35999999975
2021-09-24 09:00:00,43499.0,2021-09-24 09:00:00,43499.0,-976.44,312117.91999999975,212117.91999999975
2021-09-24 14:15:00,42450.0,2021-09-25 01:00:00,42423.01,-26.99,312090.92999999976,212090.92999999976
2021-09-25 01:15:00,42130.61,2021-09-25 04:00:00,42663.81,-533.2,311557.72999999975,211557.72999999975
2021-09-25 04:15:00,42808.86,2021-09-25 08:00:00,42242.0,-566.86,310990.86999999976,210990.86999999976
2021-09-25 08:15:00,42112.51,2021-09-25 08:30:00,41820.68,291.83,311282.6999999997,211282.69999999975
2021-09-25 08:45:00,42625.4,2021-09-26 00:45:00,42560.42,-64.98,311217.71999999974,211217.71999999974
2021-09-26 01:00:00,42417.58,2021-09-26 09:00:00,41492.76,924.82,312142.53999999975,212142.53999999975
2021-09-26 09:15:00,42302.07,2021-09-26 17:15:00,43179.01,876.94,313019.47999999975,213019.47999999975
2021-09-26 17:30:00,43177.51,2021-09-26 20:00:00,43354.41,-176.9,312842.5799999997,212842.57999999975
2021-09-26 20:15:00,43612.12,2021-09-26 22:30:00,43466.26,-145.86,312696.71999999974,212696.71999999977
2021-09-26 22:45:00,42887.51,2021-09-27 00:15:00,43048.11,-160.6,312536.11999999976,212536.11999999976
2021-09-27 00:30:00,43431.49,2021-09-27 06:30:00,44037.7,606.21,313142.3299999997,213142.32999999975
2021-09-27 06:45:00,43722.06,2021-09-27 22:00:00,43121.65,600.41,313742.73999999976,213742.73999999976
2021-09-27 22:15:00,43281.95,2021-09-27 23:00:00,43043.0,-238.95,313503.78999999975,213503.78999999975
2021-09-27 23:15:00,42656.24,2021-09-28 03:45:00,42527.0,129.24,313633.02999999974,213633.02999999974
2021-09-28 04:00:00,42605.02,2021-09-28 06:45:00,42194.42,-670.3,312962.72999999975,212962.72999999975
2021-09-28 07:00:00,42014.23,2021-09-28 20:45:00,41746.03,268.2,313230.92999999976,213230.92999999976
2021-09-28 21:00:00,41843.99,2021-09-28 23:15:00,41538.36,-305.63,312925.29999999976,212925.29999999976
2021-09-28 23:30:00,40971.41,2021-09-29 00:15:00,41354.7,-383.29,312542.0099999998,212542.00999999975
2021-09-29 00:30:00,41592.49,2021-09-29 13:15:00,42038.92,446.43,312988.4399999997,212988.43999999974
2021-09-29 13:30:00,41910.7,2021-09-29 23:15:00,41384.13,526.57,313515.0099999998,213515.00999999975
2021-09-29 23:30:00,41450.0,2021-09-30 05:00:00,43538.94,2088.94,315603.9499999997,215603.94999999975
2021-09-30 07:00:00,43216.87,2021-09-30 12:15:00,43178.42,38.45,315642.3999999998,215642.39999999976
2021-09-30 12:30:00,43655.93,2021-09-30 13:45:00,43051.49,-604.44,315037.95999999973,215037.95999999976
2021-09-30 14:00:00,42987.51,2021-09-30 18:15:00,43386.55,-399.04,314638.91999999975,214638.91999999975
2021-09-30 18:30:00,43911.11,2021-09-30 20:15:00,43608.4,-302.71,314336.20999999973,214336.20999999976
2021-09-30 20:30:00,43173.72,2021-09-30 22:00:00,43660.38,-486.66,313849.54999999976,213849.54999999976
2021-09-30 22:15:00,43866.48,2021-10-01 02:30:00,43402.15,-464.33,313385.21999999974,213385.21999999977
2021-10-01 02:45:00,43373.51,2021-10-01 05:15:00,43685.35,-311.84,313073.3799999998,213073.37999999977
2021-10-01 05:30:00,43828.74,2021-10-01 10:15:00,47084.54,3255.8,316329.17999999976,216329.17999999976
2021-10-01 14:30:00,46774.32,2021-10-01 16:15:00,47431.55,-1052.15,315277.0299999998,215277.02999999977
2021-10-01 18:15:00,47661.18,2021-10-02 01:45:00,47718.86,57.68,315334.70999999973,215334.70999999976
2021-10-02 02:00:00,47674.38,2021-10-02 13:45:00,47812.0,-545.12,314789.58999999973,214789.58999999976
2021-10-02 16:45:00,47981.54,2021-10-02 23:15:00,47785.0,-196.54,314593.04999999976,214593.04999999976
2021-10-02 23:30:00,47666.21,2021-10-03 01:45:00,47507.28,158.93,314751.97999999975,214751.97999999975
2021-10-03 02:00:00,47689.99,2021-10-03 08:45:00,47811.0,121.01,314872.98999999976,214872.98999999976
2021-10-03 09:00:00,47640.0,2021-10-03 12:45:00,47947.51,-421.82,314451.16999999975,214451.16999999975
2021-10-03 13:30:00,48119.5,2021-10-03 20:00:00,48712.94,593.44,315044.60999999975,215044.60999999975
2021-10-03 20:15:00,48634.5,2021-10-04 07:00:00,47714.51,919.99,315964.59999999974,215964.59999999974
2021-10-04 07:15:00,47774.11,2021-10-04 11:00:00,47470.01,-304.1,315660.49999999977,215660.49999999974
2021-10-04 11:15:00,47413.91,2021-10-04 13:30:00,47878.23,-542.82,315117.6799999997,215117.67999999973
2021-10-04 13:45:00,48101.09,2021-10-04 14:15:00,48184.01,82.92,315200.59999999974,215200.59999999974
2021-10-04 14:30:00,47727.46,2021-10-04 15:45:00,47747.79,-20.33,315180.2699999998,215180.26999999976
2021-10-04 16:00:00,48141.37,2021-10-05 04:15:00,49190.89,1049.52,316229.78999999975,216229.78999999975
2021-10-05 04:30:00,49141.97,2021-10-05 08:15:00,49452.41,-310.44,315919.34999999974,215919.34999999974
2021-10-05 08:30:00,49807.18,2021-10-06 00:45:00,51320.07,1512.89,317432.23999999976,217432.23999999976
2021-10-06 01:00:00,51125.57,2021-10-06 05:15:00,51509.48,-686.27,316745.96999999974,216745.96999999977
2021-10-06 06:15:00,51624.12,2021-10-06 08:15:00,50976.67,-767.55,315978.4199999998,215978.41999999978
2021-10-06 08:30:00,50660.02,2021-10-06 10:15:00,51090.0,-429.98,315548.43999999977,215548.43999999977
2021-10-06 10:30:00,51355.2,2021-10-06 13:00:00,54741.43,3386.23,318934.6699999998,218934.66999999978
2021-10-06 13:15:00,54441.12,2021-10-06 18:00:00,54893.58,-452.46,318482.2099999998,218482.2099999998
2021-10-06 18:15:00,54996.64,2021-10-07 00:15:00,54935.99,-60.65,318421.5599999998,218421.5599999998
2021-10-07 00:30:00,54743.99,2021-10-07 04:00:00,55030.51,-286.52,318135.0399999998,218135.0399999998
2021-10-07 04:15:00,55128.06,2021-10-07 06:45:00,54587.31,-540.75,317594.2899999998,217594.2899999998
2021-10-07 07:00:00,54381.1,2021-10-07 13:15:00,54036.39,344.71,317938.99999999977,217938.9999999998
2021-10-07 13:30:00,54703.94,2021-10-07 14:30:00,53920.0,-1156.09,316782.9099999998,216782.9099999998
2021-10-07 22:30:00,53868.99,2021-10-08 01:15:00,54311.32,-442.33,316340.57999999984,216340.5799999998
2021-10-08 01:30:00,54310.61,2021-10-08 04:45:00,53924.85,-385.76,315954.81999999983,215954.8199999998
2021-10-08 05:00:00,53767.01,2021-10-08 06:45:00,54162.32,-395.31,315559.5099999998,215559.5099999998
2021-10-08 07:00:00,54471.97,2021-10-08 11:30:00,55372.37,900.4,316459.9099999998,216459.9099999998
2021-10-08 11:45:00,55300.99,2021-10-09 03:00:00,54312.14,988.85,317448.7599999998,217448.7599999998
2021-10-09 03:15:00,54531.9,2021-10-09 16:15:00,55035.01,503.11,317951.86999999976,217951.8699999998
2021-10-09 16:30:00,54784.35,2021-10-09 21:45:00,54860.45,-76.1,317875.7699999998,217875.7699999998
2021-10-09 22:00:00,54964.5,2021-10-10 01:00:00,54704.23,-260.27,317615.49999999977,217615.4999999998
2021-10-10 01:15:00,54586.6,2021-10-10 02:45:00,54654.72,-68.12,317547.3799999998,217547.3799999998
2021-10-10 03:00:00,54781.44,2021-10-10 08:45:00,55619.0,837.56,318384.9399999998,218384.9399999998
2021-10-10 09:00:00,55133.86,2021-10-10 15:15:00,55211.37,-77.51,318307.4299999998,218307.4299999998
2021-10-10 15:30:00,55390.09,2021-10-10 20:15:00,56300.0,909.91,319217.3399999998,219217.3399999998
2021-10-10 20:30:00,55514.97,2021-10-11 00:45:00,55183.96,331.01,319548.3499999998,219548.3499999998
2021-10-11 01:00:00,55460.0,2021-10-11 10:30:00,56416.27,956.27,320504.61999999976,220504.6199999998
2021-10-11 10:45:00,56229.89,2021-10-11 12:45:00,56498.07,-268.18,320236.4399999998,220236.4399999998
2021-10-11 13:00:00,56740.25,2021-10-11 19:45:00,57501.9,761.65,320998.0899999998,220998.0899999998
2021-10-11 20:00:00,56990.01,2021-10-12 05:30:00,56842.99,147.02,321145.10999999975,221145.10999999978
2021-10-12 05:45:00,57423.12,2021-10-12 09:45:00,56975.38,-447.74,320697.36999999976,220697.3699999998
2021-10-12 10:00:00,56814.34,2021-10-12 20:00:00,54779.12,2035.22,322732.5899999998,222732.5899999998
2021-10-12 20:15:00,55436.58,2021-10-13 05:00:00,56071.41,634.83,323367.4199999998,223367.41999999978
2021-10-13 05:15:00,55980.97,2021-10-13 14:15:00,55060.77,920.2,324287.61999999976,224287.6199999998
2021-10-13 14:30:00,55819.86,2021-10-14 02:15:00,58584.66,2764.8,327052.4199999998,227052.41999999978
2021-10-14 06:30:00,57855.94,2021-10-14 11:00:00,57875.73,-19.79,327032.6299999998,227032.62999999977
2021-10-14 11:15:00,58039.65,2021-10-14 14:15:00,57585.11,-454.54,326578.08999999973,226578.08999999976
2021-10-14 14:30:00,57342.32,2021-10-14 18:30:00,57696.56,-354.24,326223.84999999974,226223.84999999977
2021-10-14 18:45:00,58072.58,2021-10-14 19:15:00,57370.04,-1138.53,325085.3199999998,225085.31999999977
2021-10-14 23:15:00,57280.0,2021-10-15 02:00:00,57155.13,124.87,325210.18999999977,225210.18999999977
2021-10-15 02:15:00,58703.1,2021-10-15 02:15:00,58703.1,-1032.66,324177.5299999998,224177.52999999977
2021-10-15 08:15:00,59075.59,2021-10-15 12:45:00,59298.61,-223.02,323954.5099999998,223954.50999999978
2021-10-15 13:00:00,59648.02,2021-10-15 20:15:00,62604.1,2956.08,326910.58999999973,226910.58999999976
2021-10-15 20:30:00,62344.56,2021-10-16 03:45:00,61691.63,652.93,327563.5199999998,227563.51999999976
2021-10-16 04:00:00,62126.13,2021-10-16 09:15:00,61637.27,-488.86,327074.6599999998,227074.65999999977
2021-10-16 09:30:00,61633.03,2021-10-16 19:15:00,61035.22,597.81,327672.46999999974,227672.46999999977
2021-10-16 19:30:00,61041.73,2021-10-17 05:00:00,60983.33,-58.4,327614.0699999998,227614.06999999977
2021-10-17 05:15:00,60808.42,2021-10-17 09:00:00,60849.99,-41.57,327572.49999999977,227572.49999999977
2021-10-17 09:15:00,61041.7,2021-10-17 15:15:00,60858.51,-183.19,327389.30999999976,227389.30999999976
2021-10-17 15:30:00,60673.77,2021-10-17 21:15:00,59861.77,812.0,328201.30999999976,228201.30999999976
2021-10-17 21:30:00,60362.16,2021-10-18 07:15:00,62484.45,2122.29,330323.59999999974,230323.59999999977
2021-10-18 07:45:00,61929.37,2021-10-18 13:30:00,61375.15,554.22,330877.8199999998,230877.81999999977
2021-10-18 13:45:00,61854.29,2021-10-18 18:45:00,61868.94,14.65,330892.46999999974,230892.46999999977
2021-10-18 19:00:00,61299.95,2021-10-18 22:30:00,61719.99,-420.04,330472.42999999976,230472.42999999976
2021-10-18 22:45:00,62091.45,2021-10-19 06:15:00,62419.99,328.54,330800.96999999974,230800.96999999977
2021-10-19 06:30:00,62113.01,2021-10-19 13:30:00,62732.71,-1040.31,329760.6599999998,229760.65999999977
2021-10-19 15:00:00,62708.85,2021-10-20 05:15:00,63925.7,1216.85,330977.5099999998,230977.50999999978
2021-10-20 05:30:00,63728.68,2021-10-20 08:00:00,64070.0,-341.32,330636.18999999977,230636.18999999977
2021-10-20 08:15:00,64168.9,2021-10-20 19:00:00,66758.24,2589.34,333225.5299999998,233225.52999999977
2021-10-20 20:00:00,66099.99,2021-10-21 07:45:00,65128.87,971.12,334196.6499999998,234196.64999999976
2021-10-21 08:00:00,65475.09,2021-10-21 11:15:00,66047.16,572.07,334768.71999999974,234768.71999999977
2021-10-21 11:30:00,64873.64,2021-10-22 02:45:00,62884.5,1989.14,336757.85999999975,236757.85999999978
2021-10-22 03:00:00,63233.22,2021-10-22 13:30:00,63310.01,76.79,336834.6499999998,236834.6499999998
2021-10-22 13:45:00,62485.47,2021-10-23 00:00:00,60611.32,1874.15,338708.7999999998,238708.79999999978
2021-10-23 00:15:00,61003.55,2021-10-23 07:00:00,61043.52,39.97,338748.7699999998,238748.7699999998
2021-10-23 07:15:00,60880.95,2021-10-23 11:00:00,60861.72,19.23,338767.99999999977,238767.9999999998
2021-10-23 11:15:00,61267.69,2021-10-23 20:00:00,61086.84,-180.85,338587.1499999998,238587.1499999998
2021-10-23 20:15:00,61041.53,2021-10-24 09:00:00,61148.01,-106.48,338480.6699999998,238480.66999999978
2021-10-24 09:15:00,61220.0,2021-10-24 11:15:00,60758.31,-461.69,338018.97999999975,238018.97999999978
2021-10-24 11:30:00,60324.37,2021-10-24 18:45:00,60173.39,150.98,338169.9599999998,238169.9599999998
2021-10-24 19:00:00,60632.66,2021-10-25 07:15:00,62688.96,2056.3,340226.2599999998,240226.25999999978
2021-10-25 18:00:00,62967.76,2021-10-26 00:00:00,62995.0,-27.24,340199.0199999998,240199.0199999998
2021-10-26 00:15:00,63317.26,2021-10-26 03:00:00,62852.75,-583.15,339615.86999999976,239615.8699999998
2021-10-26 03:15:00,62730.01,2021-10-26 07:45:00,62495.28,234.73,339850.5999999998,239850.5999999998
2021-10-26 08:00:00,63026.84,2021-10-26 12:00:00,62778.38,-248.46,339602.1399999998,239602.1399999998
2021-10-26 12:15:00,62561.4,2021-10-27 03:00:00,60667.34,1894.06,341496.19999999984,241496.1999999998
2021-10-27 03:15:00,60880.91,2021-10-27 07:00:00,60770.08,-110.83,341385.3699999998,241385.36999999982
2021-10-27 07:15:00,60401.16,2021-10-27 10:45:00,58995.25,1405.91,342791.2799999998,242791.27999999982
2021-10-27 11:00:00,59222.66,2021-10-27 18:45:00,58776.01,-446.65,342344.62999999983,242344.62999999983
2021-10-27 19:00:00,58349.2,2021-10-27 20:00:00,58910.57,-1163.33,341181.2999999998,241181.29999999984
2021-10-28 03:00:00,59095.37,2021-10-28 13:30:00,61788.31,2692.94,343874.2399999999,243874.23999999985
2021-10-28 17:00:00,61100.0,2021-10-28 18:30:00,59176.98,1923.02,345797.25999999983,245797.25999999983
2021-10-28 18:45:00,60171.76,2021-10-28 21:00:00,60784.05,612.29,346409.5499999998,246409.54999999984
2021-10-28 21:15:00,60558.78,2021-10-29 01:00:00,61332.2,-773.42,345636.12999999983,245636.12999999983
2021-10-29 01:15:00,62026.51,2021-10-29 05:15:00,61271.2,-755.31,344880.81999999983,244880.81999999983
2021-10-29 05:30:00,60739.59,2021-10-29 14:45:00,61281.18,-541.59,344339.22999999986,244339.22999999984
2021-10-29 15:00:00,61944.57,2021-10-29 19:00:00,62182.65,238.08,344577.3099999998,244577.30999999982
2021-10-29 19:15:00,62130.0,2021-10-30 10:15:00,61464.32,665.68,345242.9899999998,245242.98999999982
2021-10-30 10:30:00,61760.01,2021-10-30 14:00:00,61486.85,-273.16,344969.82999999984,244969.8299999998
2021-10-30 14:15:00,61054.21,2021-10-30 17:30:00,61349.0,-294.79,344675.0399999998,244675.0399999998
2021-10-30 17:45:00,61455.05,2021-10-30 22:15:00,61448.5,-6.55,344668.4899999998,244668.48999999982
2021-10-30 22:30:00,61331.07,2021-10-30 23:45:00,61895.19,-564.12,344104.3699999998,244104.36999999982
2021-10-31 00:00:00,62388.4,2021-10-31 02:45:00,61791.15,-717.4,343386.96999999986,243386.96999999983
2021-10-31 03:45:00,61768.51,2021-10-31 17:00:00,60623.54,1144.97,344531.9399999998,244531.93999999983
2021-10-31 17:15:00,60971.72,2021-11-01 02:00:00,61261.74,290.02,344821.95999999985,244821.95999999982
2021-11-01 02:15:00,60263.26,2021-11-01 02:15:00,60263.26,-957.11,343864.84999999986,243864.84999999983
2021-11-01 04:30:00,60634.85,2021-11-01 14:15:00,61804.26,1169.41,345034.25999999983,245034.25999999983
2021-11-01 14:30:00,61746.4,2021-11-01 19:30:00,60913.91,832.49,345866.7499999998,245866.74999999983
2021-11-01 19:45:00,61484.92,2021-11-01 20:45:00,60715.69,-769.23,345097.5199999998,245097.51999999981
2021-11-01 21:00:00,60546.28,2021-11-01 23:15:00,61061.86,-515.58,344581.9399999998,244581.93999999983
2021-11-01 23:30:00,61161.13,2021-11-02 13:45:00,63494.4,2333.27,346915.20999999985,246915.20999999982
2021-11-02 18:00:00,63432.44,2021-11-03 00:30:00,63086.27,346.17,347261.37999999983,247261.37999999983
2021-11-03 00:45:00,63560.43,2021-11-03 02:00:00,62941.29,-755.72,346505.6599999998,246505.65999999983
2021-11-03 04:30:00,62902.14,2021-11-03 15:45:00,62210.59,691.55,347197.20999999985,247197.20999999982
2021-11-03 16:00:00,62499.99,2021-11-03 18:00:00,62575.56,-1319.5,345877.70999999985,245877.70999999982
2021-11-04 01:00:00,62625.03,2021-11-04 13:30:00,61783.41,841.62,346719.32999999984,246719.3299999998
2021-11-04 13:45:00,62155.53,2021-11-04 14:45:00,61817.46,-338.07,346381.2599999998,246381.2599999998
2021-11-04 15:00:00,61236.06,2021-11-04 23:00:00,61313.74,-77.68,346303.57999999984,246303.5799999998
2021-11-04 23:15:00,61464.72,2021-11-05 09:00:00,62161.92,697.2,347000.7799999998,247000.77999999982
2021-11-05 09:15:00,61931.07,2021-11-06 04:00:00,61110.53,820.54,347821.31999999983,247821.31999999983
2021-11-06 04:15:00,61285.27,2021-11-06 06:45:00,61318.58,33.31,347854.62999999983,247854.62999999983
2021-11-06 07:00:00,61057.58,2021-11-06 15:45:00,60690.75,366.83,348221.45999999985,248221.45999999982
2021-11-06 16:00:00,60806.99,2021-11-07 06:15:00,62100.0,1293.01,349514.46999999986,249514.46999999983
2021-11-07 06:30:00,61942.51,2021-11-07 09:45:00,62021.81,-79.3,349435.1699999998,249435.16999999984
2021-11-07 10:00:00,62194.28,2021-11-07 15:00:00,61964.88,-229.4,349205.76999999984,249205.76999999984
2021-11-07 15:15:00,61764.73,2021-11-07 17:30:00,62286.34,-521.61,348684.15999999986,248684.15999999986
2021-11-07 17:45:00,62489.79,2021-11-08 03:15:00,65151.16,2661.37,351345.52999999985,251345.52999999985
2021-11-08 13:30:00,65630.08,2021-11-08 15:15:00,65795.34,-165.26,351180.26999999984,251180.26999999984
2021-11-08 15:30:00,66200.01,2021-11-08 19:15:00,66011.43,-188.58,350991.6899999998,250991.68999999986
2021-11-08 19:30:00,65879.34,2021-11-08 21:00:00,66322.69,-443.35,350548.33999999985,250548.33999999985
2021-11-08 21:15:00,66364.99,2021-11-09 07:45:00,67895.48,1530.49,352078.82999999984,252078.82999999984
2021-11-09 08:00:00,67765.75,2021-11-09 13:30:00,67879.98,-114.23,351964.59999999986,251964.59999999983
2021-11-09 13:45:00,68147.1,2021-11-09 14:45:00,67427.75,-862.02,351102.57999999984,251102.57999999984
2021-11-09 15:00:00,67191.25,2021-11-09 20:15:00,67086.14,105.11,351207.6899999998,251207.68999999983
2021-11-09 20:30:00,67358.3,2021-11-10 02:15:00,67147.96,-210.34,350997.34999999986,250997.34999999983
2021-11-10 02:30:00,66911.09,2021-11-10 10:15:00,66948.24,-37.15,350960.19999999984,250960.19999999984
2021-11-10 10:30:00,67029.18,2021-11-10 13:30:00,67637.38,-1104.09,349856.10999999987,249856.10999999984
2021-11-10 18:30:00,68064.55,2021-11-10 21:15:00,64867.87,3196.68,353052.7899999998,253052.78999999983
2021-11-10 21:30:00,65143.99,2021-11-11 13:45:00,64822.74,-321.25,352731.5399999998,252731.53999999983
2021-11-11 14:00:00,64552.86,2021-11-11 22:00:00,65008.81,-455.95,352275.58999999985,252275.58999999982
2021-11-11 22:15:00,65270.96,2021-11-12 00:45:00,64875.65,-395.31,351880.2799999998,251880.27999999982
2021-11-12 01:00:00,64599.93,2021-11-12 01:15:00,64603.13,-3.2,351877.07999999984,251877.0799999998
2021-11-12 01:30:00,65183.86,2021-11-12 05:30:00,64870.3,-313.56,351563.5199999998,251563.51999999981
2021-11-12 05:45:00,64748.04,2021-11-12 17:45:00,63613.99,1134.05,352697.56999999983,252697.5699999998
2021-11-12 18:00:00,63799.21,2021-11-13 02:30:00,63992.73,193.52,352891.0899999998,252891.0899999998
2021-11-13 02:45:00,63756.25,2021-11-13 13:45:00,63644.96,111.29,353002.3799999998,253002.3799999998
2021-11-13 14:00:00,64158.22,2021-11-13 18:00:00,64577.32,419.1,353421.4799999998,253421.4799999998
2021-11-13 18:15:00,64345.88,2021-11-13 21:45:00,64414.71,-68.83,353352.6499999998,253352.64999999982
2021-11-13 22:00:00,64452.83,2021-11-14 02:30:00,64742.25,289.42,353642.06999999983,253642.06999999983
2021-11-14 02:45:00,64688.26,2021-11-14 13:00:00,64570.78,117.48,353759.5499999998,253759.54999999984
2021-11-14 13:15:00,64756.59,2021-11-14 14:45:00,64387.45,-369.14,353390.4099999998,253390.40999999983
2021-11-14 15:00:00,64049.11,2021-11-14 20:45:00,64262.86,-213.75,353176.6599999998,253176.65999999983
2021-11-14 21:00:00,64338.31,2021-11-15 06:30:00,65819.71,1481.4,354658.0599999998,254658.05999999982
2021-11-15 06:45:00,65720.0,2021-11-15 08:45:00,65793.17,-73.17,354584.8899999998,254584.8899999998
2021-11-15 09:00:00,66354.62,2021-11-15 11:30:00,65844.97,-639.17,353945.7199999998,253945.7199999998
2021-11-15 12:00:00,65752.84,2021-11-16 00:00:00,62698.68,3054.16,356999.8799999998,256999.8799999998
2021-11-16 01:30:00,62181.37,2021-11-16 03:15:00,60919.25,-1512.3,355487.57999999984,255487.5799999998
2021-11-16 03:30:00,60701.8,2021-11-16 10:30:00,59948.25,753.55,356241.1299999998,256241.1299999998
2021-11-16 10:45:00,60173.01,2021-11-16 18:00:00,60595.26,422.25,356663.3799999998,256663.3799999998
2021-11-16 18:15:00,60399.99,2021-11-16 20:45:00,59757.66,642.33,357305.7099999998,257305.7099999998
2021-11-16 21:00:00,60619.23,2021-11-17 00:00:00,60138.01,-481.22,356824.48999999976,256824.4899999998
2021-11-17 00:15:00,59771.34,2021-11-17 07:15:00,59486.49,284.85,357109.3399999998,257109.3399999998
2021-11-17 07:30:00,60050.0,2021-11-17 09:30:00,59303.75,-746.25,356363.0899999998,256363.0899999998
2021-11-17 09:45:00,58970.0,2021-11-17 10:30:00,59814.84,-844.84,355518.24999999977,255518.2499999998
2021-11-17 10:45:00,60510.38,2021-11-17 14:30:00,59890.39,-619.99,354898.2599999998,254898.2599999998
2021-11-17 14:45:00,59641.93,2021-11-17 17:45:00,60256.83,-614.9,354283.3599999998,254283.3599999998
2021-11-17 18:00:00,60407.31,2021-11-18 03:30:00,60127.88,-279.43,354003.9299999998,254003.92999999982
2021-11-18 03:45:00,59880.45,2021-11-18 19:00:00,58130.78,1749.67,355753.59999999986,255753.59999999983
2021-11-18 19:15:00,58160.96,2021-11-18 22:00:00,57266.06,-1333.39,354420.20999999985,254420.20999999982
2021-11-18 22:30:00,56974.59,2021-11-19 08:00:00,56401.77,572.82,354993.0299999998,254993.02999999982
2021-11-19 08:15:00,57373.99,2021-11-20 14:00:00,58536.09,1162.1,356155.12999999983,256155.12999999983
2021-11-20 14:15:00,58397.26,2021-11-20 18:00:00,57964.79,432.47,356587.59999999986,256587.59999999983
2021-11-20 18:15:00,59416.86,2021-11-20 18:15:00,59416.86,-967.58,355620.01999999984,255620.01999999984
2021-11-21 02:00:00,59277.25,2021-11-21 15:30:00,59233.75,43.5,355663.51999999984,255663.51999999984
2021-11-21 15:45:00,59214.54,2021-11-21 19:15:00,59356.61,142.07,355805.58999999985,255805.58999999985
2021-11-21 19:30:00,59340.41,2021-11-22 08:45:00,57367.14,1973.27,357778.85999999987,257778.85999999984
2021-11-22 09:00:00,57724.0,2021-11-22 12:45:00,57178.18,-545.82,357233.0399999998,257233.03999999983
2021-11-22 13:00:00,56882.3,2021-11-22 13:15:00,57241.1,-358.8,356874.2399999999,256874.23999999985
2021-11-22 13:30:00,59031.36,2021-11-22 13:30:00,59031.36,-1511.46,355362.77999999985,255362.77999999985
2021-11-22 15:15:00,58170.75,2021-11-23 01:30:00,56625.81,1544.94,356907.71999999986,256907.71999999986
2021-11-23 01:45:00,56873.48,2021-11-23 06:00:00,56525.01,-348.47,356559.2499999999,256559.24999999985
2021-11-23 06:15:00,56348.28,2021-11-23 09:30:00,56940.89,-592.61,355966.6399999999,255966.63999999987
2021-11-23 09:45:00,56657.05,2021-11-23 11:15:00,56256.0,-401.05,355565.58999999985,255565.58999999988
2021-11-23 11:30:00,56068.8,2021-11-23 14:30:00,56752.07,-683.27,354882.3199999999,254882.3199999999
2021-11-23 14:45:00,57696.45,2021-11-24 01:30:00,57400.56,-295.89,354586.4299999999,254586.42999999988
2021-11-24 01:45:00,57077.44,2021-11-24 09:00:00,56907.91,169.53,354755.95999999985,254755.95999999988
2021-11-24 09:15:00,57019.59,2021-11-24 13:30:00,56375.7,-643.89,354112.06999999983,254112.06999999986
2021-11-24 13:45:00,56068.95,2021-11-24 15:45:00,56750.7,-1004.65,353107.41999999987,253107.41999999987
2021-11-24 18:00:00,56879.19,2021-11-25 03:45:00,57779.29,900.1,354007.5199999999,254007.51999999987
2021-11-25 04:00:00,57644.17,2021-11-25 07:15:00,57511.83,132.34,354139.85999999987,254139.85999999987
2021-11-25 07:30:00,57702.1,2021-11-25 21:45:00,58858.8,1156.7,355296.5599999999,255296.55999999988
2021-11-25 22:00:00,58661.4,2021-11-25 23:00:00,59174.98,-703.38,354593.1799999999,254593.17999999988
2021-11-26 17:30:00,54597.45,2021-11-26 23:00:00,54125.96,-471.49,354121.6899999999,254121.6899999999
2021-11-26 23:15:00,53709.49,2021-11-27 02:15:00,54438.67,-729.18,353392.5099999999,253392.5099999999
2021-11-27 02:30:00,54453.74,2021-11-27 09:45:00,54605.42,151.68,353544.1899999999,253544.1899999999
2021-11-27 10:00:00,54445.97,2021-11-27 13:15:00,54917.63,-471.66,353072.5299999999,253072.52999999988
2021-11-27 13:30:00,55149.29,2021-11-27 20:15:00,54983.17,-166.12,352906.4099999999,252906.4099999999
2021-11-27 20:30:00,54431.23,2021-11-27 22:15:00,54675.33,-244.1,352662.3099999999,252662.30999999988
2021-11-27 22:30:00,54797.21,2021-11-28 02:00:00,54310.86,-486.35,352175.95999999985,252175.95999999988
2021-11-28 02:15:00,54200.01,2021-11-28 06:00:00,54251.78,-51.77,352124.1899999999,252124.1899999999
2021-11-28 06:15:00,54408.66,2021-11-28 12:45:00,54391.56,-17.1,352107.08999999985,252107.08999999988
2021-11-28 13:00:00,54310.01,2021-11-28 18:30:00,53830.67,479.34,352586.4299999999,252586.42999999988
2021-11-28 18:45:00,54138.56,2021-11-29 00:30:00,57874.93,3736.37,356322.7999999999,256322.79999999987
2021-11-29 03:00:00,57367.3,2021-11-29 16:30:00,57218.29,149.01,356471.8099999999,256471.80999999988
2021-11-29 16:45:00,57497.99,2021-11-29 19:15:00,58205.42,707.43,357179.2399999999,257179.23999999987
2021-11-29 19:30:00,58080.91,2021-11-30 08:15:00,56549.38,1531.53,358710.7699999999,258710.76999999987
2021-11-30 08:30:00,56994.27,2021-11-30 15:30:00,58594.92,1600.65,360311.41999999987,260311.41999999987
2021-11-30 15:45:00,57260.01,2021-11-30 18:30:00,57854.55,-594.54,359716.8799999999,259716.87999999986
2021-11-30 18:45:00,58366.0,2021-11-30 21:15:00,57317.67,-1048.33,358668.5499999999,258668.54999999987
2021-11-30 21:30:00,56928.49,2021-12-01 08:00:00,56982.69,-54.2,358614.34999999986,258614.34999999986
2021-12-01 08:15:00,57654.45,2021-12-01 10:30:00,57000.65,-653.8,357960.5499999999,257960.54999999987
2021-12-01 10:45:00,57001.01,2021-12-01 13:15:00,57374.37,-373.36,357587.1899999999,257587.1899999999
2021-12-01 13:30:00,57763.5,2021-12-01 17:30:00,58420.02,656.52,358243.70999999985,258243.70999999988
2021-12-01 17:45:00,58059.43,2021-12-02 04:45:00,56497.63,1561.8,359805.5099999999,259805.50999999986
2021-12-02 05:00:00,56809.99,2021-12-02 10:45:00,56590.0,-219.99,359585.5199999999,259585.51999999987
2021-12-02 11:00:00,56175.05,2021-12-02 14:30:00,57032.91,-857.86,358727.6599999999,258727.6599999999
2021-12-02 14:45:00,57105.48,2021-12-02 15:15:00,56653.79,-451.69,358275.96999999986,258275.96999999988
2021-12-02 15:30:00,56185.48,2021-12-02 20:00:00,56909.51,-724.03,357551.9399999999,257551.9399999999
2021-12-02 20:15:00,57023.23,2021-12-03 01:15:00,56538.03,-485.2,357066.7399999999,257066.73999999987
2021-12-03 01:30:00,56488.93,2021-12-03 05:15:00,56487.5,1.43,357068.16999999987,257068.16999999987
2021-12-03 05:30:00,56944.24,2021-12-03 13:30:00,57142.04,197.8,357265.96999999986,257265.96999999986
2021-12-03 13:45:00,56912.35,2021-12-03 20:15:00,51439.17,5473.18,362739.14999999985,262739.14999999985
2021-12-03 20:30:00,52900.01,2021-12-04 00:45:00,53055.01,155.0,362894.14999999985,262894.14999999985
2021-12-04 01:00:00,52667.29,2021-12-04 05:15:00,45512.18,7155.11,370049.25999999983,270049.25999999983
2021-12-04 05:30:00,46486.98,2021-12-05 05:30:00,49212.7,2725.72,372774.9799999998,272774.9799999998
2021-12-05 15:00:00,48555.73,2021-12-05 17:00:00,48603.36,-47.63,372727.3499999998,272727.3499999998
2021-12-05 17:15:00,49024.98,2021-12-06 05:30:00,48820.9,-204.08,372523.2699999998,272523.2699999998
2021-12-06 05:45:00,48666.74,2021-12-06 11:30:00,48318.19,348.55,372871.8199999998,272871.8199999998
2021-12-06 11:45:00,48572.09,2021-12-07 04:00:00,51112.71,2540.62,375412.43999999977,275412.43999999977
2021-12-07 17:15:00,51015.54,2021-12-08 14:00:00,49262.83,1752.71,377165.1499999998,277165.1499999998
2021-12-08 14:15:00,50296.25,2021-12-08 22:30:00,50784.0,487.75,377652.8999999998,277652.8999999998
2021-12-08 22:45:00,50214.61,2021-12-09 07:15:00,49560.53,654.08,378306.9799999998,278306.9799999998
2021-12-09 07:30:00,50058.33,2021-12-09 08:45:00,49494.13,-564.2,377742.7799999998,277742.7799999998
2021-12-09 09:00:00,49373.86,2021-12-10 01:15:00,48458.96,914.9,378657.6799999998,278657.6799999998
2021-12-10 01:30:00,48437.9,2021-12-10 06:30:00,48264.06,-173.84,378483.8399999998,278483.8399999998
2021-12-10 06:45:00,47841.18,2021-12-10 10:45:00,48194.77,-353.59,378130.24999999977,278130.24999999977
2021-12-10 11:00:00,48491.23,2021-12-10 14:30:00,49453.98,962.75,379092.99999999977,279092.99999999977
2021-12-10 14:45:00,48269.77,2021-12-10 14:45:00,48269.77,-1205.66,377887.3399999998,277887.3399999998
2021-12-10 20:15:00,48290.9,2021-12-10 22:30:00,47950.04,-340.86,377546.4799999998,277546.4799999998
2021-12-10 22:45:00,47524.21,2021-12-11 01:15:00,48020.12,-495.91,377050.56999999983,277050.56999999983
2021-12-11 01:30:00,48082.43,2021-12-11 07:00:00,48074.07,-8.36,377042.20999999985,277042.20999999985
2021-12-11 07:15:00,47970.04,2021-12-11 08:00:00,48065.3,-95.26,376946.94999999984,276946.94999999984
2021-12-11 08:15:00,48838.71,2021-12-11 19:15:00,48689.75,-148.96,376797.9899999998,276797.9899999998
2021-12-11 19:30:00,48479.47,2021-12-11 22:45:00,48811.1,-331.63,376466.3599999998,276466.3599999998
2021-12-11 23:00:00,49182.34,2021-12-12 04:30:00,49060.11,-122.23,376344.12999999983,276344.12999999983
2021-12-12 04:45:00,48851.37,2021-12-12 11:15:00,48996.18,-144.81,376199.31999999983,276199.31999999983
2021-12-12 11:30:00,49242.92,2021-12-12 21:15:00,50219.82,976.9,377176.21999999986,277176.21999999986
2021-12-12 21:30:00,50064.02,2021-12-13 05:30:00,48951.31,1112.71,378288.9299999999,278288.9299999999
2021-12-13 05:45:00,49221.11,2021-12-13 08:00:00,48888.23,-861.47,377427.4599999999,277427.4599999999
2021-12-13 12:30:00,48652.76,2021-12-13 21:45:00,46760.07,1892.69,379320.1499999999,279320.1499999999
2021-12-13 22:00:00,47128.98,2021-12-14 06:00:00,46738.35,-390.63,378929.5199999999,278929.5199999999
2021-12-14 06:15:00,46482.4,2021-12-14 08:00:00,47086.54,-604.14,378325.3799999999,278325.3799999999
2021-12-14 08:15:00,47122.48,2021-12-14 13:15:00,47395.13,272.65,378598.0299999999,278598.0299999999
2021-12-14 13:30:00,47049.71,2021-12-14 20:15:00,47173.99,-124.28,378473.7499999999,278473.7499999999
2021-12-14 20:30:00,47793.24,2021-12-15 01:45:00,48063.52,270.28,378744.0299999999,278744.0299999999
2021-12-15 02:00:00,47897.8,2021-12-15 08:00:00,48267.06,-369.26,378374.7699999999,278374.7699999999
2021-12-15 08:15:00,48479.37,2021-12-15 11:00:00,48300.0,-179.37,378195.3999999999,278195.3999999999
2021-12-15 11:15:00,48110.74,2021-12-15 18:15:00,47268.68,842.06,379037.4599999999,279037.4599999999
2021-12-15 18:30:00,47646.77,2021-12-16 03:15:00,48798.08,1151.31,380188.7699999999,280188.7699999999
2021-12-16 03:30:00,48790.71,2021-12-16 09:45:00,48954.59,-163.88,380024.8899999999,280024.8899999999
2021-12-16 10:00:00,49136.51,2021-12-16 12:30:00,48816.88,-319.63,379705.2599999999,279705.2599999999
2021-12-16 12:45:00,48685.12,2021-12-17 04:30:00,47842.21,842.91,380548.16999999987,280548.16999999987
2021-12-17 04:45:00,47904.62,2021-12-17 06:30:00,47537.27,-367.35,380180.8199999999,280180.8199999999
2021-12-17 06:45:00,47418.4,2021-12-17 15:30:00,46294.92,1123.48,381304.2999999999,281304.2999999999
2021-12-17 15:45:00,46487.19,2021-12-17 20:00:00,46678.12,190.93,381495.22999999986,281495.22999999986
2021-12-17 20:15:00,46388.19,2021-12-18 04:15:00,46277.2,110.99,381606.21999999986,281606.21999999986
2021-12-18 04:30:00,46400.88,2021-12-18 13:30:00,46790.8,389.92,381996.13999999984,281996.13999999984
2021-12-18 13:45:00,46621.71,2021-12-18 20:30:00,46674.71,-53.0,381943.13999999984,281943.13999999984
2021-12-18 20:45:00,46835.56,2021-12-19 01:00:00,46770.58,-64.98,381878.15999999986,281878.15999999986
2021-12-19 01:15:00,46461.81,2021-12-19 02:30:00,46911.31,-449.5,381428.65999999986,281428.65999999986
2021-12-19 02:45:00,47121.61,2021-12-19 06:30:00,47528.48,406.87,381835.52999999985,281835.52999999985
2021-12-19 06:45:00,47471.12,2021-12-19 12:45:00,47234.99,236.13,382071.65999999986,282071.65999999986
2021-12-19 13:00:00,47420.59,2021-12-19 14:00:00,47190.99,-229.6,381842.0599999999,281842.0599999999
2021-12-19 14:15:00,47263.45,2021-12-19 22:30:00,47015.4,248.05,382090.10999999987,282090.10999999987
2021-12-19 22:45:00,47282.4,2021-12-19 23:30:00,46929.0,-353.4,381736.70999999985,281736.70999999985
2021-12-19 23:45:00,46668.63,2021-12-20 00:45:00,46866.62,-197.99,381538.71999999986,281538.71999999986
2021-12-20 01:00:00,47117.51,2021-12-20 05:30:00,46569.11,-548.4,380990.31999999983,280990.31999999983
2021-12-20 05:45:00,46432.8,2021-12-20 16:30:00,46252.41,180.39,381170.70999999985,281170.70999999985
2021-12-20 16:45:00,46391.53,2021-12-20 22:30:00,46848.26,456.73,381627.4399999998,281627.4399999998
2021-12-20 22:45:00,46751.57,2021-12-21 03:00:00,47082.43,-330.86,381296.57999999984,281296.57999999984
2021-12-21 03:15:00,47258.55,2021-12-21 12:15:00,49150.63,1892.08,383188.65999999986,283188.65999999986
2021-12-21 14:45:00,48603.6,2021-12-21 21:15:00,48763.67,-160.07,383028.58999999985,283028.58999999985
2021-12-21 21:30:00,49161.04,2021-12-22 00:30:00,48845.54,-315.5,382713.08999999985,282713.08999999985
2021-12-22 00:45:00,48633.9,2021-12-22 02:00:00,48982.12,-348.22,382364.8699999999,282364.8699999999
2021-12-22 02:15:00,49224.22,2021-12-22 05:30:00,49070.11,-154.11,382210.7599999999,282210.7599999999
2021-12-22 05:45:00,48961.42,2021-12-22 08:15:00,49344.73,-383.31,381827.4499999999,281827.4499999999
2021-12-22 08:30:00,49437.25,2021-12-22 09:15:00,49137.54,-299.71,381527.7399999999,281527.7399999999
2021-12-22 09:30:00,48982.29,2021-12-22 15:45:00,48858.42,123.87,381651.60999999987,281651.60999999987
2021-12-22 16:00:00,49111.28,2021-12-22 18:15:00,48817.79,-293.49,381358.1199999999,281358.1199999999
2021-12-22 18:30:00,48589.32,2021-12-22 20:45:00,48940.8,-524.15,380833.96999999986,280833.96999999986
2021-12-22 21:45:00,49019.91,2021-12-22 23:15:00,48769.56,-250.35,380583.6199999999,280583.6199999999
2021-12-22 23:30:00,48542.32,2021-12-23 12:15:00,48464.01,78.31,380661.9299999999,280661.9299999999
2021-12-23 12:30:00,48648.34,2021-12-23 19:30:00,51192.75,2544.41,383206.33999999985,283206.33999999985
2021-12-23 23:00:00,50675.12,2021-12-24 01:15:00,51064.12,-389.0,382817.33999999985,282817.33999999985
2021-12-24 01:30:00,51221.7,2021-12-24 04:30:00,51070.99,-150.71,382666.62999999983,282666.62999999983
2021-12-24 04:45:00,50934.06,2021-12-24 09:00:00,51118.77,-184.71,382481.9199999998,282481.9199999998
2021-12-24 09:15:00,51270.42,2021-12-24 11:45:00,50976.0,-294.42,382187.4999999998,282187.4999999998
2021-12-24 12:00:00,50949.58,2021-12-24 15:45:00,50923.47,26.11,382213.6099999998,282213.6099999998
2021-12-24 16:00:00,51145.5,2021-12-24 20:00:00,51127.08,-18.42,382195.1899999998,282195.1899999998
2021-12-24 20:15:00,51039.9,2021-12-25 02:00:00,50967.32,72.58,382267.76999999984,282267.76999999984
2021-12-25 02:15:00,51050.01,2021-12-25 05:45:00,50880.64,-169.37,382098.39999999985,282098.39999999985
2021-12-25 06:00:00,50650.01,2021-12-25 17:30:00,50378.24,271.77,382370.16999999987,282370.16999999987
2021-12-25 17:45:00,50787.07,2021-12-25 22:00:00,50867.56,80.49,382450.65999999986,282450.65999999986
2021-12-25 22:15:00,50688.02,2021-12-26 10:15:00,50000.41,687.61,383138.26999999984,283138.26999999984
2021-12-26 10:30:00,50080.85,2021-12-26 11:45:00,49729.35,-513.73,382624.53999999986,282624.53999999986
2021-12-27 00:30:00,50624.2,2021-12-27 03:00:00,50934.55,-310.35,382314.1899999999,282314.1899999999
2021-12-27 03:15:00,51035.56,2021-12-27 07:30:00,50788.49,-247.07,382067.1199999999,282067.1199999999
2021-12-27 07:45:00,50693.01,2021-12-27 12:15:00,50863.23,-170.22,381896.8999999999,281896.8999999999
2021-12-27 12:30:00,51148.0,2021-12-27 19:00:00,51627.11,479.11,382376.0099999999,282376.0099999999
2021-12-27 19:15:00,51509.95,2021-12-28 04:15:00,48730.1,2779.85,385155.85999999987,285155.85999999987
2021-12-28 08:00:00,49413.4,2021-12-28 10:00:00,48867.57,-665.79,384490.0699999999,284490.0699999999
2021-12-28 16:00:00,48589.31,2021-12-29 02:30:00,47891.55,697.76,385187.8299999999,285187.8299999999
2021-12-29 02:45:00,47974.56,2021-12-29 06:45:00,47833.58,-140.98,385046.8499999999,285046.8499999999
2021-12-29 07:00:00,47637.72,2021-12-29 14:15:00,47310.2,327.52,385374.36999999994,285374.36999999994
2021-12-29 14:30:00,47742.15,2021-12-29 18:45:00,47515.29,-226.86,385147.50999999995,285147.50999999995
2021-12-29 19:00:00,47349.9,2021-12-30 03:15:00,46544.87,805.03,385952.54,285952.54
2021-12-30 03:30:00,46653.43,2021-12-30 15:30:00,47321.72,668.29,386620.82999999996,286620.82999999996
2021-12-30 15:45:00,47144.27,2021-12-30 17:00:00,47517.44,-373.17,386247.66,286247.66
2021-12-30 17:15:00,47668.76,2021-12-30 20:30:00,47407.82,-260.94,385986.72,285986.72
2021-12-30 20:45:00,47178.56,2021-12-31 04:00:00,47165.92,12.64,385999.36,285999.36
2021-12-31 04:15:00,47386.8,2021-12-31 07:15:00,47031.83,-354.97,385644.39,285644.39
2021-12-31 07:30:00,46874.3,2021-12-31 08:00:00,47145.55,-271.25,385373.14,285373.14
2021-12-31 08:15:00,47864.89,2021-12-31 13:30:00,48038.35,173.46,385546.60000000003,285546.60000000003
2021-12-31 13:45:00,47943.72,2021-12-31 23:15:00,46338.21,1605.51,387152.11000000004,287152.11000000004
2021-12-31 23:30:00,46460.89,2022-01-01 07:00:00,46980.0,519.11,387671.22000000003,287671.22000000003
2022-01-01 07:15:00,46950.34,2022-01-01 15:15:00,47009.82,-59.48,387611.74000000005,287611.74000000005
2022-01-01 15:30:00,47314.77,2022-01-01 19:15:00,47382.0,67.23,387678.97000000003,287678.97000000003
2022-01-01 19:30:00,47317.01,2022-01-02 08:30:00,47156.68,160.33,387839.30000000005,287839.30000000005
2022-01-02 08:45:00,47211.36,2022-01-02 14:00:00,47174.0,-37.36,387801.94000000006,287801.94000000006
2022-01-02 14:15:00,47057.39,2022-01-02 16:15:00,47403.46,-346.07,387455.87000000005,287455.87000000005
2022-01-02 16:30:00,47532.65,2022-01-02 17:45:00,47402.3,-130.35,387325.5200000001,287325.5200000001
2022-01-02 18:00:00,47255.67,2022-01-02 21:45:00,47023.47,232.2,387557.7200000001,287557.7200000001
2022-01-02 22:00:00,47181.31,2022-01-03 01:15:00,47030.62,-150.69,387407.0300000001,287407.0300000001
2022-01-03 01:30:00,46978.18,2022-01-03 09:45:00,46979.01,-0.83,387406.20000000007,287406.20000000007
2022-01-03 10:00:00,47182.14,2022-01-03 13:45:00,47157.33,-24.81,387381.3900000001,287381.3900000001
2022-01-03 14:00:00,47026.92,2022-01-03 22:45:00,46214.28,812.64,388194.0300000001,288194.0300000001
2022-01-03 23:00:00,46371.01,2022-01-04 15:45:00,46925.28,554.27,388748.3000000001,288748.3000000001
2022-01-04 16:00:00,46768.64,2022-01-04 20:00:00,46199.76,568.88,389317.1800000001,289317.1800000001
2022-01-04 20:15:00,46398.4,2022-01-05 11:00:00,46627.75,229.35,389546.5300000001,289546.5300000001
2022-01-05 11:15:00,46551.2,2022-01-05 14:30:00,46310.53,240.67,389787.20000000007,289787.20000000007
2022-01-05 14:45:00,46682.79,2022-01-05 17:30:00,46150.94,-531.85,389255.3500000001,289255.3500000001
2022-01-05 17:45:00,46007.99,2022-01-06 00:15:00,43500.0,2507.99,391763.3400000001,291763.3400000001
2022-01-06 00:30:00,43659.38,2022-01-06 03:30:00,43081.57,-577.81,391185.5300000001,291185.5300000001
2022-01-06 03:45:00,42817.38,2022-01-06 13:30:00,42977.72,-160.34,391025.19000000006,291025.19000000006
2022-01-06 13:45:00,43123.15,2022-01-06 21:45:00,43105.1,-18.05,391007.1400000001,291007.1400000001
2022-01-06 22:00:00,43019.92,2022-01-07 05:00:00,41710.56,1309.36,392316.50000000006,292316.50000000006
2022-01-07 05:15:00,41770.29,2022-01-07 11:30:00,42251.2,480.91,392797.41000000003,292797.41000000003
2022-01-07 11:45:00,42249.99,2022-01-07 16:30:00,41706.82,543.17,393340.58,293340.58
2022-01-07 16:45:00,42131.75,2022-01-07 22:15:00,41760.85,-370.9,392969.68,292969.68
2022-01-07 22:30:00,41555.72,2022-01-08 00:30:00,41794.31,-238.59,392731.08999999997,292731.08999999997
2022-01-08 00:45:00,41992.23,2022-01-08 12:15:00,41891.64,-100.59,392630.49999999994,292630.49999999994
2022-01-08 12:30:00,41760.07,2022-01-08 21:00:00,41147.93,612.14,393242.63999999996,293242.63999999996
2022-01-08 21:15:00,41406.11,2022-01-09 05:30:00,41867.45,461.34,393703.98,293703.98
2022-01-09 05:45:00,41762.99,2022-01-09 16:15:00,41728.0,34.99,393738.97,293738.97
2022-01-09 16:30:00,41759.97,2022-01-09 22:45:00,42193.23,433.26,394172.23,294172.23
2022-01-09 23:00:00,41980.74,2022-01-10 04:00:00,41973.0,7.74,394179.97,294179.97
2022-01-10 04:15:00,42100.0,2022-01-10 08:15:00,41908.04,-191.96,393988.00999999995,293988.00999999995
2022-01-10 08:30:00,41753.77,2022-01-10 14:30:00,40670.54,1083.23,395071.23999999993,295071.23999999993
2022-01-10 14:45:00,40768.6,2022-01-10 17:15:00,41122.41,353.81,395425.04999999993,295425.04999999993
2022-01-10 17:30:00,40664.68,2022-01-10 20:30:00,41447.82,-783.14,394641.9099999999,294641.9099999999
2022-01-10 20:45:00,41698.68,2022-01-11 08:15:00,42205.55,506.87,395148.7799999999,295148.7799999999
2022-01-11 08:30:00,41996.92,2022-01-11 15:45:00,41716.42,280.5,395429.2799999999,295429.2799999999
2022-01-11 16:00:00,42126.54,2022-01-12 02:00:00,42624.85,498.31,395927.5899999999,295927.5899999999
2022-01-12 02:15:00,42609.9,2022-01-12 09:00:00,42639.02,-29.12,395898.4699999999,295898.4699999999
2022-01-12 09:15:00,42849.4,2022-01-13 00:15:00,43843.35,993.95,396892.4199999999,296892.4199999999
2022-01-13 00:30:00,43734.99,2022-01-13 07:45:00,43682.7,52.29,396944.7099999999,296944.7099999999
2022-01-13 08:00:00,43820.01,2022-01-13 14:45:00,44120.24,300.23,397244.9399999999,297244.9399999999
2022-01-13 15:00:00,43755.0,2022-01-14 05:00:00,42716.09,1038.91,398283.84999999986,298283.84999999986
2022-01-14 05:15:00,42760.03,2022-01-14 07:45:00,42635.62,-124.41,398159.4399999999,298159.4399999999
2022-01-14 08:00:00,42442.65,2022-01-14 13:45:00,42140.37,302.28,398461.7199999999,298461.7199999999
2022-01-14 14:00:00,42317.52,2022-01-15 01:15:00,43046.29,728.77,399190.48999999993,299190.48999999993
2022-01-15 01:30:00,42892.86,2022-01-15 07:30:00,42968.13,-75.27,399115.2199999999,299115.2199999999
2022-01-15 07:45:00,43073.99,2022-01-15 12:15:00,42938.06,-135.93,398979.2899999999,298979.2899999999
2022-01-15 12:30:00,42699.99,2022-01-15 14:15:00,42925.68,-225.69,398753.5999999999,298753.5999999999
2022-01-15 14:30:00,43161.66,2022-01-15 21:15:00,43353.0,191.34,398944.93999999994,298944.93999999994
2022-01-15 21:30:00,43273.0,2022-01-16 06:30:00,43069.45,203.55,399148.48999999993,299148.48999999993
2022-01-16 06:45:00,43171.67,2022-01-16 10:30:00,43094.5,-77.17,399071.31999999995,299071.31999999995
2022-01-16 10:45:00,42904.4,2022-01-16 13:30:00,42952.47,-48.07,399023.24999999994,299023.24999999994
2022-01-16 13:45:00,43097.88,2022-01-16 18:45:00,43042.16,-55.72,398967.52999999997,298967.52999999997
2022-01-16 19:00:00,42898.69,2022-01-16 21:45:00,42937.0,-38.31,398929.22,298929.22
2022-01-16 22:00:00,43165.44,2022-01-17 00:45:00,42873.86,-291.58,398637.63999999996,298637.63999999996
2022-01-17 01:00:00,42849.53,2022-01-17 06:00:00,42669.45,180.08,398817.72,298817.72
2022-01-17 06:15:00,42800.0,2022-01-17 15:45:00,42467.49,-332.51,398485.20999999996,298485.20999999996
2022-01-17 16:00:00,42215.14,2022-01-17 22:15:00,41782.95,432.19,398917.39999999997,298917.39999999997
2022-01-17 22:30:00,42243.27,2022-01-18 04:00:00,42025.91,-217.36,398700.04,298700.04
2022-01-18 04:15:00,41951.63,2022-01-18 06:00:00,42200.0,-248.37,398451.67,298451.67
2022-01-18 06:15:00,42260.93,2022-01-18 07:45:00,42040.0,-220.93,398230.74,298230.74
2022-01-18 08:00:00,41843.17,2022-01-18 09:45:00,41885.84,-42.67,398188.07,298188.07
2022-01-18 10:00:00,41965.01,2022-01-18 13:00:00,41637.79,-327.22,397860.85000000003,297860.85000000003
2022-01-18 13:15:00,41433.42,2022-01-18 20:45:00,41767.25,-333.83,397527.02,297527.02
2022-01-18 21:00:00,41937.55,2022-01-19 03:00:00,42256.79,319.24,397846.26,297846.26
2022-01-19 03:15:00,42250.12,2022-01-19 10:45:00,41494.2,755.92,398602.18,298602.18
2022-01-19 11:00:00,42043.22,2022-01-19 15:45:00,41971.31,-71.91,398530.27,298530.27
2022-01-19 16:00:00,41734.55,2022-01-20 05:45:00,41878.84,-144.29,398385.98000000004,298385.98000000004
2022-01-20 06:00:00,41941.4,2022-01-20 18:00:00,43016.39,1074.99,399460.97000000003,299460.97000000003
2022-01-20 18:15:00,42939.39,2022-01-21 01:45:00,39864.03,3075.36,402536.33,302536.33
2022-01-21 07:45:00,39106.42,2022-01-21 11:45:00,38878.71,-227.71,402308.62,302308.62
2022-01-21 12:00:00,38576.85,2022-01-21 13:15:00,38376.93,199.92,402508.54,302508.54
2022-01-21 13:30:00,38624.0,2022-01-21 19:30:00,38195.53,-428.47,402080.07,302080.07
2022-01-21 19:45:00,37967.04,2022-01-22 02:45:00,36460.42,1506.62,403586.69,303586.69
2022-01-22 03:00:00,36579.68,2022-01-22 05:30:00,35899.3,-680.38,402906.31,302906.31
2022-01-22 05:45:00,35728.06,2022-01-22 10:15:00,34879.16,848.9,403755.21,303755.21
2022-01-22 10:30:00,35605.86,2022-01-22 14:30:00,35473.62,-132.24,403622.97000000003,303622.97000000003
2022-01-22 14:45:00,35008.02,2022-01-22 21:15:00,35212.11,-204.09,403418.88,303418.88
2022-01-22 21:30:00,35467.05,2022-01-23 02:30:00,35017.37,-449.68,402969.2,302969.2
2022-01-23 02:45:00,34862.32,2022-01-23 07:00:00,35467.05,-604.73,402364.47000000003,302364.47000000003
2022-01-23 07:15:00,35655.91,2022-01-23 14:15:00,35594.99,-60.92,402303.55000000005,302303.55000000005
2022-01-23 14:30:00,35423.16,2022-01-23 21:15:00,35281.25,141.91,402445.46,302445.46
2022-01-23 21:30:00,35469.75,2022-01-24 01:15:00,35787.61,317.86,402763.32,302763.32
2022-01-24 01:30:00,35665.61,2022-01-24 15:15:00,33861.53,1804.08,404567.4,304567.4
2022-01-24 15:30:00,34242.43,2022-01-24 23:45:00,36648.31,2405.88,406973.28,306973.28
2022-01-25 00:00:00,36484.93,2022-01-25 07:45:00,36035.0,449.93,407423.21,307423.21
2022-01-25 08:00:00,36329.48,2022-01-25 21:00:00,36707.19,377.71,407800.92000000004,307800.92000000004
2022-01-25 21:15:00,36530.31,2022-01-26 03:00:00,36996.34,-466.03,407334.89,307334.89
2022-01-26 03:15:00,37131.69,2022-01-26 06:45:00,37284.0,152.31,407487.2,307487.2
2022-01-26 07:00:00,37164.83,2022-01-26 09:15:00,37742.11,-621.51,406865.69,306865.69
2022-01-26 09:30:00,37779.26,2022-01-26 18:15:00,37783.02,3.76,406869.45,306869.45
2022-01-26 18:30:00,37705.41,2022-01-26 19:00:00,37831.57,-956.02,405913.43,305913.43
2022-01-27 07:15:00,36211.64,2022-01-27 16:00:00,36507.6,295.96,406209.39,306209.39
2022-01-27 16:15:00,36425.13,2022-01-27 22:15:00,36101.12,324.01,406533.4,306533.4
2022-01-27 22:30:00,36633.09,2022-01-28 07:30:00,36996.57,363.48,406896.88,306896.88
2022-01-28 07:45:00,36788.86,2022-01-28 13:30:00,36767.32,21.54,406918.42,306918.42
2022-01-28 13:45:00,36890.17,2022-01-29 02:15:00,37550.0,659.83,407578.25,307578.25
2022-01-29 02:30:00,37485.0,2022-01-29 07:00:00,37714.21,-229.21,407349.04,307349.04
2022-01-29 07:15:00,37866.44,2022-01-29 14:30:00,38009.76,143.32,407492.36,307492.36
2022-01-29 14:45:00,37599.38,2022-01-29 18:30:00,37584.3,15.08,407507.44,307507.44
2022-01-29 18:45:00,37781.35,2022-01-29 22:00:00,38166.87,385.52,407892.96,307892.96
2022-01-29 22:15:00,38085.7,2022-01-30 04:45:00,38081.78,3.92,407896.88,307896.88
2022-01-30 05:00:00,38270.48,2022-01-30 08:15:00,38105.51,-164.97,407731.91000000003,307731.91000000003
2022-01-30 08:30:00,37976.0,2022-01-30 22:45:00,37767.09,208.91,407940.82,307940.82
2022-01-30 23:00:00,38161.23,2022-01-31 00:00:00,37695.85,-550.07,407390.75,307390.75
2022-01-31 00:15:00,37666.5,2022-01-31 06:00:00,36998.44,668.06,408058.81,308058.81
2022-01-31 06:15:00,37039.93,2022-01-31 11:15:00,37143.88,103.95,408162.76,308162.76
2022-01-31 11:30:00,36976.74,2022-01-31 13:45:00,37225.71,-248.97,407913.79000000004,307913.79000000004
2022-01-31 14:00:00,37307.08,2022-02-01 01:30:00,38264.19,957.11,408870.9,308870.9
2022-02-01 01:45:00,38223.22,2022-02-01 03:45:00,38570.11,-346.89,408524.01,308524.01
2022-02-01 04:00:00,38570.0,2022-02-01 09:00:00,38927.15,357.15,408881.16000000003,308881.16000000003
2022-02-01 09:15:00,38461.42,2022-02-01 12:00:00,38449.07,12.35,408893.51,308893.51
2022-02-01 12:15:00,38553.86,2022-02-01 15:15:00,38392.39,-161.47,408732.04000000004,308732.04000000004
2022-02-01 15:30:00,38313.57,2022-02-01 16:30:00,38854.16,-540.59,408191.45,308191.45
2022-02-01 16:45:00,39092.04,2022-02-01 18:45:00,38516.49,-575.55,407615.9,307615.9
2022-02-01 19:00:00,38498.19,2022-02-02 10:30:00,38471.55,26.64,407642.54000000004,307642.54000000004
2022-02-02 10:45:00,38540.64,2022-02-02 14:00:00,38373.63,-167.01,407475.53,307475.53
2022-02-02 14:15:00,38320.28,2022-02-02 19:15:00,37482.61,837.67,408313.2,308313.2
2022-02-02 19:30:00,37582.81,2022-02-02 21:15:00,37192.79,-390.02,407923.18,307923.18
2022-02-02 21:30:00,36685.68,2022-02-03 05:00:00,36843.64,-157.96,407765.22,307765.22
2022-02-03 05:15:00,36978.01,2022-02-03 09:30:00,36936.92,-41.09,407724.12999999995,307724.12999999995
2022-02-03 09:45:00,36594.0,2022-02-03 11:30:00,36687.63,-93.63,407630.49999999994,307630.49999999994
2022-02-03 11:45:00,36754.99,2022-02-03 19:15:00,36620.0,-134.99,407495.50999999995,307495.50999999995
2022-02-03 19:30:00,36512.09,2022-02-03 21:15:00,36799.55,-287.46,407208.04999999993,307208.04999999993
2022-02-03 21:30:00,36919.38,2022-02-04 11:30:00,37912.73,993.35,408201.3999999999,308201.3999999999
2022-02-04 11:45:00,37800.02,2022-02-04 14:30:00,37871.82,-71.8,408129.5999999999,308129.5999999999
2022-02-04 14:45:00,37939.57,2022-02-04 19:30:00,40540.47,2600.9,410730.49999999994,310730.49999999994
2022-02-05 07:00:00,41431.94,2022-02-05 15:15:00,41666.01,-234.07,410496.42999999993,310496.42999999993
2022-02-05 15:30:00,41795.35,2022-02-05 16:30:00,41461.3,-334.05,410162.37999999995,310162.37999999995
2022-02-05 16:45:00,41276.89,2022-02-05 17:30:00,41439.46,-162.57,409999.80999999994,309999.80999999994
2022-02-05 17:45:00,41575.72,2022-02-06 03:45:00,41429.06,-146.66,409853.14999999997,309853.14999999997
2022-02-06 04:00:00,41358.44,2022-02-06 07:45:00,41588.0,-326.06,409527.08999999997,309527.08999999997
2022-02-06 09:45:00,41630.0,2022-02-06 14:30:00,41467.15,-162.85,409364.24,309364.24
2022-02-06 14:45:00,41300.0,2022-02-06 17:00:00,41585.0,-285.0,409079.24,309079.24
2022-02-06 17:15:00,41685.61,2022-02-07 00:00:00,42065.01,379.4,409458.64,309458.64
2022-02-07 00:15:00,41750.0,2022-02-07 02:00:00,42198.06,-448.06,409010.58,309010.58
2022-02-07 02:15:00,42367.61,2022-02-07 08:15:00,42568.26,200.65,409211.23000000004,309211.23000000004
2022-02-07 08:30:00,42579.65,2022-02-07 11:15:00,42665.43,-85.78,409125.45,309125.45
2022-02-07 11:30:00,42683.35,2022-02-07 23:30:00,43853.73,1170.38,410295.83,310295.83
2022-02-07 23:45:00,43829.99,2022-02-08 03:30:00,44086.19,-256.2,410039.63,310039.63
2022-02-08 03:45:00,44162.22,2022-02-08 06:15:00,45121.9,959.68,410999.31,310999.31
2022-02-08 06:30:00,44675.16,2022-02-08 20:00:00,43270.4,1404.76,412404.07,312404.07
2022-02-08 20:15:00,43610.61,2022-02-09 01:45:00,43852.25,241.64,412645.71,312645.71
2022-02-09 02:00:00,43349.99,2022-02-09 06:15:00,43664.0,-314.01,412331.7,312331.7
2022-02-09 06:30:00,43720.51,2022-02-09 23:45:00,44358.08,637.57,412969.27,312969.27
2022-02-10 00:00:00,44166.82,2022-02-10 07:30:00,43948.28,218.54,413187.81,313187.81
2022-02-10 07:45:00,44066.19,2022-02-10 13:15:00,44932.03,865.84,414053.65,314053.65
2022-02-10 13:30:00,43778.02,2022-02-10 13:30:00,43778.02,-916.38,413137.27,313137.27
2022-02-10 14:45:00,44367.8,2022-02-10 19:00:00,44633.39,265.59,413402.86000000004,313402.86000000004
2022-02-10 19:15:00,44557.08,2022-02-11 06:45:00,43214.64,1342.44,414745.30000000005,314745.30000000005
2022-02-11 07:00:00,43245.67,2022-02-11 18:15:00,43333.19,87.52,414832.82000000007,314832.82000000007
2022-02-11 18:30:00,42700.0,2022-02-12 07:45:00,42090.76,609.24,415442.06000000006,315442.06000000006
2022-02-12 08:00:00,42301.04,2022-02-12 14:30:00,41986.09,-537.77,414904.29000000004,314904.29000000004
2022-02-12 21:15:00,42414.04,2022-02-12 23:30:00,42097.27,316.77,415221.06000000006,315221.06000000006
2022-02-12 23:45:00,42199.87,2022-02-13 16:15:00,42286.74,86.87,415307.93000000005,315307.93000000005
2022-02-13 16:30:00,42238.7,2022-02-13 20:30:00,42261.74,-23.04,415284.8900000001,315284.8900000001
2022-02-13 20:45:00,42421.79,2022-02-14 01:00:00,42085.77,-336.02,414948.87000000005,314948.87000000005
2022-02-14 01:15:00,41856.55,2022-02-14 06:30:00,41885.95,-29.4,414919.47000000003,314919.47000000003
2022-02-14 06:45:00,42154.26,2022-02-14 18:30:00,42469.07,314.81,415234.28,315234.28
2022-02-14 18:45:00,42227.85,2022-02-14 21:45:00,42215.33,12.52,415246.80000000005,315246.80000000005
2022-02-14 22:00:00,42579.69,2022-02-15 08:00:00,43854.34,1274.65,416521.45000000007,316521.45000000007
2022-02-15 17:15:00,43875.6,2022-02-15 22:30:00,44232.3,-411.56,416109.8900000001,316109.8900000001
2022-02-15 23:15:00,44320.0,2022-02-16 00:00:00,44381.9,61.9,416171.7900000001,316171.7900000001
2022-02-16 00:15:00,44180.8,2022-02-16 05:45:00,44044.9,135.9,416307.6900000001,316307.6900000001
2022-02-16 06:00:00,44097.2,2022-02-16 13:15:00,43985.0,-112.2,416195.4900000001,316195.4900000001
2022-02-16 13:30:00,43842.4,2022-02-16 18:30:00,43676.0,166.4,416361.89000000013,316361.89000000013
2022-02-16 18:45:00,43817.8,2022-02-16 23:30:00,44028.0,210.2,416572.09000000014,316572.09000000014
2022-02-16 23:45:00,43860.7,2022-02-17 06:15:00,43785.9,74.8,416646.89000000013,316646.89000000013
2022-02-17 06:30:00,43817.0,2022-02-17 08:15:00,43622.5,-194.5,416452.39000000013,316452.39000000013
2022-02-17 08:30:00,43476.8,2022-02-17 20:00:00,40947.95,2528.85,418981.2400000001,318981.2400000001
2022-02-18 01:30:00,40861.0,2022-02-18 10:45:00,40769.6,-91.4,418889.8400000001,318889.8400000001
2022-02-18 11:00:00,40396.5,2022-02-18 23:15:00,40033.9,362.6,419252.44000000006,319252.44000000006
2022-02-18 23:30:00,40028.7,2022-02-19 08:30:00,40188.8,160.1,419412.54000000004,319412.54000000004
2022-02-19 08:45:00,39961.4,2022-02-19 15:45:00,39950.1,11.3,419423.84,319423.84
2022-02-19 16:00:00,40184.1,2022-02-19 21:00:00,39983.8,-200.3,419223.54000000004,319223.54000000004
2022-02-19 21:15:00,39914.9,2022-02-20 11:00:00,38150.93,1763.97,420987.51,320987.51
2022-02-20 16:00:00,38468.7,2022-02-20 21:00:00,38170.4,-298.3,420689.21,320689.21
2022-02-20 21:15:00,38084.9,2022-02-20 22:30:00,38304.6,-219.7,420469.51,320469.51
2022-02-20 22:45:00,38795.6,2022-02-20 22:45:00,38795.6,-451.85,420017.66000000003,320017.66000000003
2022-02-20 23:45:00,38368.1,2022-02-21 00:45:00,38719.2,-351.1,419666.56000000006,319666.56000000006
2022-02-21 01:00:00,39035.7,2022-02-21 08:45:00,39045.1,9.4,419675.9600000001,319675.9600000001
2022-02-21 09:00:00,38987.9,2022-02-21 14:00:00,37703.7,1284.2,420960.1600000001,320960.1600000001
2022-02-21 14:15:00,38580.0,2022-02-21 17:45:00,38516.1,-63.9,420896.26000000007,320896.26000000007
2022-02-21 18:00:00,37852.0,2022-02-22 08:45:00,37081.2,770.8,421667.06000000006,321667.06000000006
2022-02-22 09:00:00,37122.1,2022-02-22 17:00:00,37564.6,442.5,422109.56000000006,322109.56000000006
2022-02-22 17:15:00,37457.0,2022-02-22 22:45:00,37900.0,-443.0,421666.56000000006,321666.56000000006
2022-02-22 23:00:00,38004.0,2022-02-23 02:00:00,38172.8,168.8,421835.36000000004,321835.36000000004
2022-02-23 02:15:00,37812.5,2022-02-23 05:45:00,37955.0,-142.5,421692.86000000004,321692.86000000004
2022-02-23 06:00:00,38054.5,2022-02-23 14:30:00,38869.1,814.6,422507.46,322507.46
2022-02-23 14:45:00,38640.3,2022-02-24 02:45:00,35929.62,2710.68,425218.14,325218.14
2022-02-24 08:00:00,35586.1,2022-02-24 20:00:00,38825.1,3239.0,428457.14,328457.14
2022-02-24 20:15:00,38352.5,2022-02-25 02:30:00,38692.0,-339.5,428117.64,328117.64
2022-02-25 02:45:00,38779.7,2022-02-25 07:45:00,38462.5,-317.2,427800.44,327800.44
2022-02-25 08:00:00,38222.6,2022-02-25 11:45:00,38730.0,-507.4,427293.04,327293.04
2022-02-25 12:00:00,38902.7,2022-02-25 17:45:00,38965.0,62.3,427355.33999999997,327355.33999999997
2022-02-25 18:00:00,38612.9,2022-02-25 22:30:00,39075.9,-463.0,426892.33999999997,326892.33999999997
2022-02-25 22:45:00,39400.1,2022-02-26 02:00:00,39697.1,297.0,427189.33999999997,327189.33999999997
2022-02-26 02:15:00,39645.0,2022-02-26 15:00:00,39138.4,506.6,427695.93999999994,327695.93999999994
2022-02-26 15:15:00,39231.1,2022-02-26 22:15:00,39190.8,-40.3,427655.63999999996,327655.63999999996
2022-02-26 22:30:00,39132.9,2022-02-27 05:15:00,38612.3,520.6,428176.23999999993,328176.23999999993
2022-02-27 05:30:00,38657.8,2022-02-27 13:15:00,39595.4,937.6,429113.8399999999,329113.8399999999
2022-02-27 13:30:00,38845.6,2022-02-27 13:30:00,38845.6,-708.74,428405.0999999999,328405.0999999999
2022-02-28 01:00:00,37927.1,2022-02-28 17:45:00,41454.03,3526.93,431932.0299999999,331932.0299999999
2022-03-01 02:00:00,43082.4,2022-03-01 06:45:00,43439.6,-357.2,431574.8299999999,331574.8299999999
2022-03-01 07:00:00,43517.6,2022-03-01 10:00:00,43060.6,-699.65,430875.1799999999,330875.1799999999
2022-03-01 14:45:00,43796.9,2022-03-01 20:30:00,43882.7,-85.8,430789.3799999999,330789.3799999999
2022-03-01 20:45:00,44056.3,2022-03-02 01:15:00,43908.9,-147.4,430641.97999999986,330641.97999999986
2022-03-02 01:30:00,43880.0,2022-03-02 14:15:00,43709.9,170.1,430812.07999999984,330812.07999999984
2022-03-02 14:30:00,44792.4,2022-03-02 14:30:00,44792.4,-960.13,429851.94999999984,329851.94999999984
2022-03-02 17:15:00,44120.9,2022-03-03 07:00:00,43490.8,630.1,430482.0499999998,330482.0499999998
2022-03-03 07:15:00,43536.6,2022-03-03 14:45:00,43409.1,-127.5,430354.5499999998,330354.5499999998
2022-03-03 15:00:00,43208.8,2022-03-04 04:15:00,41211.33,1997.47,432352.0199999998,332352.0199999998
2022-03-04 08:00:00,41671.8,2022-03-04 08:30:00,41369.3,-701.86,431650.1599999998,331650.1599999998
2022-03-04 15:00:00,40768.2,2022-03-05 04:15:00,38972.21,1795.99,433446.1499999998,333446.1499999998
2022-03-05 07:00:00,39046.5,2022-03-06 03:15:00,39389.4,342.9,433789.0499999998,333789.0499999998
2022-03-06 03:30:00,39322.6,2022-03-06 04:15:00,38944.4,378.2,434167.2499999998,334167.2499999998
2022-03-06 04:30:00,39396.6,2022-03-06 08:30:00,39195.7,-200.9,433966.3499999998,333966.3499999998
2022-03-06 08:45:00,39137.3,2022-03-06 13:00:00,38658.0,479.3,434445.6499999998,334445.6499999998
2022-03-06 13:15:00,38757.6,2022-03-06 19:15:00,38845.3,87.7,434533.3499999998,334533.3499999998
2022-03-06 19:30:00,38681.8,2022-03-06 22:00:00,39089.5,-407.7,434125.6499999998,334125.6499999998
2022-03-06 22:15:00,39130.0,2022-03-06 23:00:00,38560.7,-689.07,433436.5799999998,333436.5799999998
2022-03-06 23:15:00,38213.3,2022-03-07 06:15:00,38100.4,112.9,433549.4799999998,333549.4799999998
2022-03-07 06:30:00,38128.0,2022-03-07 16:45:00,38823.3,695.3,434244.7799999998,334244.7799999998
2022-03-07 17:00:00,38698.3,2022-03-07 22:00:00,38113.9,584.4,434829.1799999998,334829.1799999998
2022-03-07 22:15:00,38137.0,2022-03-08 06:00:00,38373.1,236.1,435065.2799999998,335065.2799999998
2022-03-08 06:15:00,38119.4,2022-03-08 08:00:00,38640.8,-521.4,434543.8799999998,334543.8799999998
2022-03-08 08:15:00,38776.9,2022-03-08 16:15:00,38323.8,-453.1,434090.7799999998,334090.7799999998
2022-03-08 16:30:00,38179.7,2022-03-08 17:45:00,39047.1,-941.19,433149.5899999998,333149.5899999998
2022-03-08 18:00:00,39195.3,2022-03-08 20:15:00,38568.5,-626.8,432522.7899999998,332522.7899999998
2022-03-08 20:30:00,38453.5,2022-03-09 00:30:00,38843.2,-389.7,432133.0899999998,332133.0899999998
2022-03-09 00:45:00,38930.0,2022-03-09 05:00:00,41664.92,2734.92,434868.0099999998,334868.0099999998
2022-03-09 13:30:00,41809.8,2022-03-09 15:15:00,42186.4,-376.6,434491.4099999998,334491.4099999998
2022-03-09 15:30:00,42383.7,2022-03-09 18:45:00,42029.4,-354.3,434137.1099999998,334137.1099999998
2022-03-09 19:00:00,41873.4,2022-03-10 05:45:00,38910.31,2963.09,437100.19999999984,337100.19999999984
2022-03-10 13:15:00,39296.9,2022-03-10 13:30:00,38526.9,-770.0,436330.19999999984,336330.19999999984
2022-03-10 13:45:00,38837.8,2022-03-10 19:00:00,39182.1,-344.3,435985.89999999985,335985.89999999985
2022-03-10 19:15:00,39243.3,2022-03-11 00:45:00,39270.7,27.4,436013.2999999999,336013.2999999999
2022-03-11 01:00:00,38974.2,2022-03-11 06:00:00,38689.8,284.4,436297.6999999999,336297.6999999999
2022-03-11 06:15:00,38899.9,2022-03-11 13:30:00,39305.3,405.4,436703.0999999999,336703.0999999999
2022-03-11 13:45:00,39243.8,2022-03-11 22:15:00,38859.1,384.7,437087.79999999993,337087.79999999993
2022-03-11 22:30:00,38933.8,2022-03-12 14:15:00,39011.8,78.0,437165.79999999993,337165.79999999993
2022-03-12 14:30:00,38857.3,2022-03-12 15:15:00,38918.0,-60.7,437105.0999999999,337105.0999999999
2022-03-12 15:30:00,39085.7,2022-03-12 17:00:00,39172.5,86.8,437191.8999999999,337191.8999999999
2022-03-12 17:15:00,39086.5,2022-03-13 00:45:00,38898.7,187.8,437379.6999999999,337379.6999999999
2022-03-13 01:00:00,39076.0,2022-03-13 07:45:00,39075.4,-0.6,437379.0999999999,337379.0999999999
2022-03-13 08:00:00,39039.6,2022-03-13 14:00:00,38767.1,272.5,437651.5999999999,337651.5999999999
2022-03-13 14:15:00,38853.8,2022-03-13 19:45:00,38843.4,-10.4,437641.1999999999,337641.1999999999
2022-03-13 20:00:00,38670.9,2022-03-14 02:00:00,38052.8,618.1,438259.2999999999,338259.2999999999
2022-03-14 02:15:00,38114.4,2022-03-14 13:00:00,38855.4,741.0,439000.2999999999,339000.2999999999
2022-03-14 13:15:00,38724.9,2022-03-14 21:45:00,38713.8,11.1,439011.39999999985,339011.39999999985
2022-03-14 22:00:00,38923.9,2022-03-15 00:45:00,39564.9,641.0,439652.39999999985,339652.39999999985
2022-03-15 01:00:00,39151.4,2022-03-15 09:15:00,38563.6,587.8,440240.19999999984,340240.19999999984
2022-03-15 09:30:00,38596.2,2022-03-15 22:45:00,39458.3,862.1,441102.2999999998,341102.2999999998
2022-03-15 23:00:00,39302.3,2022-03-16 01:45:00,39501.7,-199.4,440902.8999999998,340902.8999999998
2022-03-16 02:00:00,41402.8,2022-03-16 02:00:00,41402.8,-1023.03,439879.86999999976,339879.86999999976
2022-03-16 03:00:00,39453.9,2022-03-16 03:00:00,39453.9,-1458.31,438421.55999999976,338421.55999999976
2022-03-16 08:00:00,39736.8,2022-03-16 16:00:00,40670.0,933.2,439354.7599999998,339354.7599999998
2022-03-16 16:15:00,40130.8,2022-03-16 19:00:00,40204.9,-74.1,439280.6599999998,339280.6599999998
2022-03-16 19:15:00,40818.5,2022-03-17 06:15:00,40983.0,164.5,439445.1599999998,339445.1599999998
2022-03-17 06:30:00,40893.9,2022-03-17 11:45:00,40743.4,150.5,439595.6599999998,339595.6599999998
2022-03-17 12:00:00,41033.3,2022-03-17 16:45:00,40797.2,-236.1,439359.5599999998,339359.5599999998
2022-03-17 17:00:00,40620.0,2022-03-17 21:30:00,40836.8,-216.8,439142.75999999983,339142.75999999983
2022-03-17 21:45:00,40983.3,2022-03-18 00:30:00,40730.1,-253.2,438889.5599999998,338889.5599999998
2022-03-18 00:45:00,40310.1,2022-03-18 04:15:00,40533.9,-223.8,438665.75999999983,338665.75999999983
2022-03-18 04:30:00,40594.0,2022-03-18 09:30:00,40535.0,-59.0,438606.75999999983,338606.75999999983
2022-03-18 09:45:00,40499.3,2022-03-18 12:15:00,40366.3,133.0,438739.75999999983,338739.75999999983
2022-03-18 12:30:00,40525.0,2022-03-18 21:00:00,41758.5,1233.5,439973.25999999983,339973.25999999983
2022-03-18 21:15:00,41669.9,2022-03-19 11:00:00,41741.3,-71.4,439901.8599999998,339901.8599999998
2022-03-19 11:15:00,41785.1,2022-03-19 21:45:00,42090.3,305.2,440207.0599999998,340207.0599999998
2022-03-19 22:00:00,41818.8,2022-03-19 23:00:00,42053.8,-235.0,439972.0599999998,339972.0599999998
2022-03-19 23:15:00,42194.6,2022-03-20 02:15:00,41886.5,-308.1,439663.95999999985,339663.95999999985
2022-03-20 02:30:00,41793.7,2022-03-20 12:15:00,41512.3,281.4,439945.35999999987,339945.35999999987
2022-03-20 12:30:00,41675.1,2022-03-20 15:30:00,41305.7,-444.69,439500.66999999987,339500.66999999987
2022-03-20 17:15:00,41186.6,2022-03-20 19:45:00,41364.5,-177.9,439322.76999999984,339322.76999999984
2022-03-20 20:00:00,41631.9,2022-03-20 21:00:00,41230.4,-528.95,438793.81999999983,338793.81999999983
2022-03-21 01:45:00,41215.0,2022-03-21 05:00:00,40873.1,341.9,439135.71999999986,339135.71999999986
2022-03-21 05:15:00,40885.9,2022-03-21 12:15:00,41160.0,274.1,439409.81999999983,339409.81999999983
2022-03-21 12:30:00,40910.1,2022-03-21 13:15:00,41256.3,-499.35,438910.46999999986,338910.46999999986
2022-03-21 20:30:00,41210.0,2022-03-21 23:45:00,40982.0,-228.0,438682.46999999986,338682.46999999986
2022-03-22 00:00:00,40924.2,2022-03-22 01:45:00,41148.9,-224.7,438457.76999999984,338457.76999999984
2022-03-22 02:00:00,41672.3,2022-03-22 02:00:00,41672.3,-535.86,437921.90999999986,337921.90999999986
2022-03-22 06:00:00,42462.2,2022-03-22 10:00:00,42558.7,-96.5,437825.40999999986,337825.40999999986
2022-03-22 10:15:00,42677.1,2022-03-22 15:30:00,42650.1,-27.0,437798.40999999986,337798.40999999986
2022-03-22 15:45:00,42567.2,2022-03-22 21:00:00,42697.0,-129.8,437668.60999999987,337668.60999999987
2022-03-22 21:15:00,42705.6,2022-03-22 23:00:00,42509.7,-195.9,437472.70999999985,337472.70999999985
2022-03-22 23:15:00,42312.1,2022-03-23 02:00:00,42266.8,45.3,437518.00999999983,337518.00999999983
2022-03-23 02:15:00,42504.1,2022-03-23 04:00:00,42082.7,-421.4,437096.6099999998,337096.6099999998
2022-03-23 04:15:00,41820.1,2022-03-23 08:15:00,42214.5,-394.4,436702.2099999998,336702.2099999998
2022-03-23 08:30:00,42286.7,2022-03-23 11:15:00,41944.5,-342.2,436360.0099999998,336360.0099999998
2022-03-23 11:30:00,41888.9,2022-03-23 12:45:00,42335.9,-486.0,435874.0099999998,335874.0099999998
2022-03-23 15:00:00,42413.4,2022-03-23 17:30:00,42249.9,-163.5,435710.5099999998,335710.5099999998
2022-03-23 17:45:00,42149.0,2022-03-23 22:15:00,42407.3,-258.3,435452.2099999998,335452.2099999998
2022-03-23 22:30:00,42445.0,2022-03-24 03:15:00,42904.1,459.1,435911.30999999976,335911.30999999976
2022-03-24 03:30:00,42737.7,2022-03-24 06:00:00,43018.1,-280.4,435630.90999999974,335630.90999999974
2022-03-24 06:15:00,43189.7,2022-03-24 09:45:00,43004.1,-185.6,435445.30999999976,335445.30999999976
2022-03-24 10:00:00,42901.1,2022-03-24 14:30:00,42995.0,-93.9,435351.40999999974,335351.40999999974
2022-03-24 14:45:00,43564.8,2022-03-25 01:45:00,44106.8,542.0,435893.40999999974,335893.40999999974
2022-03-25 02:00:00,43969.9,2022-03-25 09:15:00,44000.0,-30.1,435863.30999999976,335863.30999999976
2022-03-25 09:30:00,44090.2,2022-03-25 15:00:00,44607.4,517.2,436380.5099999998,336380.5099999998
2022-03-25 15:15:00,44395.3,2022-03-25 21:30:00,44445.0,-49.7,436330.80999999976,336330.80999999976
2022-03-25 21:45:00,44501.3,2022-03-26 01:00:00,44165.8,-439.96,435890.84999999974,335890.84999999974
2022-03-26 12:15:00,44285.3,2022-03-26 18:15:00,44357.9,-72.6,435818.24999999977,335818.24999999977
2022-03-26 18:30:00,44379.3,2022-03-26 20:45:00,44541.1,161.8,435980.04999999976,335980.04999999976
2022-03-26 21:00:00,44380.4,2022-03-27 00:15:00,44514.5,-134.1,435845.9499999998,335845.9499999998
2022-03-27 00:30:00,44621.9,2022-03-27 03:15:00,44667.6,45.7,435891.6499999998,335891.6499999998
2022-03-27 03:30:00,44622.0,2022-03-27 13:45:00,44599.6,22.4,435914.0499999998,335914.0499999998
2022-03-27 14:00:00,44668.6,2022-03-27 19:45:00,44813.6,145.0,436059.0499999998,336059.0499999998
2022-03-27 20:00:00,44766.6,2022-03-27 20:15:00,44743.8,22.8,436081.8499999998,336081.8499999998
2022-03-27 20:30:00,46174.9,2022-03-27 20:30:00,46174.9,-740.41,435341.4399999998,335341.4399999998
2022-03-27 21:00:00,46003.9,2022-03-27 22:15:00,46789.5,-969.21,434372.2299999998,334372.2299999998
2022-03-27 23:15:00,46727.6,2022-03-28 01:15:00,46898.4,170.8,434543.0299999998,334543.0299999998
2022-03-28 01:30:00,46790.3,2022-03-28 04:45:00,47111.7,-321.4,434221.6299999998,334221.6299999998
2022-03-28 05:00:00,47287.6,2022-03-28 05:45:00,47069.5,-218.1,434003.5299999998,334003.5299999998
2022-03-28 06:00:00,46777.8,2022-03-28 10:00:00,47180.1,-425.82,433577.7099999998,333577.7099999998
2022-03-28 10:15:00,47261.9,2022-03-28 16:45:00,47449.6,187.7,433765.4099999998,333765.4099999998
2022-03-28 17:00:00,47342.0,2022-03-28 18:30:00,47731.7,-389.7,433375.7099999998,333375.7099999998
2022-03-28 18:45:00,47958.1,2022-03-28 22:30:00,47684.4,-273.7,433102.0099999998,333102.0099999998
2022-03-28 22:45:00,47528.5,2022-03-29 01:30:00,47420.2,108.3,433210.30999999976,333210.30999999976
2022-03-29 01:45:00,47519.9,2022-03-29 07:30:00,47428.5,-91.4,433118.90999999974,333118.90999999974
2022-03-29 07:45:00,47330.1,2022-03-29 10:45:00,47596.4,-266.3,432852.60999999975,332852.60999999975
2022-03-29 11:00:00,47700.2,2022-03-29 13:45:00,47677.5,-22.7,432829.90999999974,332829.90999999974
2022-03-29 14:00:00,47609.4,2022-03-29 19:00:00,47651.0,-41.6,432788.30999999976,332788.30999999976
2022-03-29 19:15:00,47766.9,2022-03-29 21:15:00,47462.1,-304.8,432483.5099999998,332483.5099999998
2022-03-29 21:30:00,47309.0,2022-03-30 02:15:00,47127.8,181.2,432664.7099999998,332664.7099999998
2022-03-30 02:30:00,47201.2,2022-03-30 10:45:00,47273.7,72.5,432737.2099999998,332737.2099999998
2022-03-30 11:00:00,47163.9,2022-03-30 17:15:00,47195.1,-31.2,432706.0099999998,332706.0099999998
2022-03-30 17:30:00,47540.1,2022-03-30 19:00:00,47151.0,-389.1,432316.9099999998,332316.9099999998
2022-03-30 19:15:00,46988.8,2022-03-31 01:00:00,47264.7,-275.9,432041.0099999998,332041.0099999998
2022-03-31 01:15:00,47304.9,2022-03-31 04:00:00,47100.1,-204.8,431836.2099999998,331836.2099999998
2022-03-31 04:15:00,47013.1,2022-03-31 08:30:00,47165.2,-152.1,431684.1099999998,331684.1099999998
2022-03-31 08:45:00,47223.2,2022-03-31 11:15:00,47181.3,-41.9,431642.2099999998,331642.2099999998
2022-03-31 11:30:00,47075.1,2022-03-31 12:30:00,47378.5,-352.54,431289.6699999998,331289.6699999998
2022-04-01 06:45:00,44773.9,2022-04-02 00:30:00,46403.1,1629.2,432918.8699999998,332918.8699999998
2022-04-02 02:30:00,46323.2,2022-04-02 09:00:00,46569.9,-246.7,432672.1699999998,332672.1699999998
2022-04-02 09:15:00,46575.4,2022-04-02 14:45:00,46603.3,27.9,432700.06999999983,332700.06999999983
2022-04-02 15:00:00,46364.5,2022-04-02 20:00:00,46226.9,137.6,432837.6699999998,332837.6699999998
2022-04-02 20:15:00,46272.3,2022-04-02 23:45:00,45794.6,-546.61,432291.0599999998,332291.0599999998
2022-04-03 01:15:00,45596.8,2022-04-03 03:45:00,45930.2,-333.4,431957.6599999998,331957.6599999998
2022-04-03 04:00:00,46157.0,2022-04-03 08:45:00,46270.6,113.6,432071.2599999998,332071.2599999998
2022-04-03 09:00:00,46192.3,2022-04-03 13:00:00,46287.9,-95.6,431975.6599999998,331975.6599999998
2022-04-03 13:15:00,46544.4,2022-04-03 17:00:00,46319.9,-224.5,431751.1599999998,331751.1599999998
2022-04-03 17:15:00,46228.4,2022-04-03 18:45:00,46577.5,-434.99,431316.1699999998,331316.1699999998
2022-04-03 21:15:00,46677.0,2022-04-03 22:45:00,46684.5,7.5,431323.6699999998,331323.6699999998
2022-04-03 23:00:00,46554.2,2022-04-04 05:30:00,46200.0,354.2,431677.8699999998,331677.8699999998
2022-04-04 05:45:00,46215.0,2022-04-04 14:45:00,45890.1,-324.9,431352.9699999998,331352.9699999998
2022-04-04 15:00:00,45629.0,2022-04-04 18:45:00,45488.8,140.2,431493.1699999998,331493.1699999998
2022-04-04 19:00:00,45681.1,2022-04-05 07:30:00,46681.3,1000.2,432493.3699999998,332493.3699999998
2022-04-05 09:30:00,46594.3,2022-04-05 12:00:00,46733.7,-139.4,432353.9699999998,332353.9699999998
2022-04-05 12:15:00,47123.2,2022-04-05 12:15:00,47123.2,-386.13,431967.8399999998,331967.8399999998
2022-04-05 13:00:00,46420.6,2022-04-05 22:15:00,45853.8,566.8,432534.6399999998,332534.6399999998
2022-04-05 22:30:00,45986.9,2022-04-05 23:45:00,45477.4,-593.59,431941.04999999976,331941.04999999976
2022-04-06 00:00:00,45035.4,2022-04-06 01:00:00,45091.8,-56.4,431884.64999999973,331884.64999999973
2022-04-06 01:15:00,45221.5,2022-04-06 10:45:00,45062.6,-158.9,431725.7499999997,331725.7499999997
2022-04-06 11:00:00,44784.5,2022-04-06 21:00:00,43863.4,921.1,432646.8499999997,332646.8499999997
2022-04-06 21:15:00,43975.0,2022-04-06 23:00:00,43365.9,-696.97,431949.8799999997,331949.8799999997
2022-04-06 23:45:00,43159.7,2022-04-07 04:00:00,43227.6,-67.9,431881.9799999997,331881.9799999997
2022-04-07 04:15:00,43349.4,2022-04-07 12:45:00,43533.9,184.5,432066.4799999997,332066.4799999997
2022-04-07 13:00:00,43392.6,2022-04-07 16:45:00,43479.9,-87.3,431979.1799999997,331979.1799999997
2022-04-07 17:00:00,43608.2,2022-04-07 21:00:00,43527.6,-80.6,431898.5799999997,331898.5799999997
2022-04-07 21:15:00,43296.8,2022-04-07 22:45:00,43605.2,-308.4,431590.1799999997,331590.1799999997
2022-04-07 23:00:00,43646.2,2022-04-08 09:45:00,43568.4,-77.8,431512.3799999997,331512.3799999997
2022-04-08 10:00:00,43524.4,2022-04-08 14:00:00,43263.5,260.9,431773.27999999974,331773.27999999974
2022-04-08 14:15:00,43539.9,2022-04-08 16:45:00,43428.0,-111.9,431661.3799999997,331661.3799999997
2022-04-08 17:00:00,43071.0,2022-04-09 05:30:00,42489.4,581.6,432242.9799999997,332242.9799999997
2022-04-09 05:45:00,42557.2,2022-04-09 15:00:00,42439.4,-117.8,432125.1799999997,332125.1799999997
2022-04-09 15:15:00,42350.0,2022-04-09 16:45:00,42434.3,-84.3,432040.8799999997,332040.8799999997
2022-04-09 17:00:00,42489.9,2022-04-10 05:30:00,42695.0,205.1,432245.9799999997,332245.9799999997
2022-04-10 05:45:00,42636.3,2022-04-10 11:45:00,42666.1,-29.8,432216.1799999997,332216.1799999997
2022-04-10 12:00:00,42765.1,2022-04-10 21:30:00,43087.9,322.8,432538.9799999997,332538.9799999997
2022-04-10 21:45:00,42693.3,2022-04-11 04:15:00,42162.5,530.8,433069.7799999997,333069.7799999997
2022-04-11 04:30:00,42200.9,2022-04-11 09:15:00,42013.4,-187.5,432882.2799999997,332882.2799999997
2022-04-11 09:30:00,41857.8,2022-04-11 23:45:00,39347.97,2509.83,435392.1099999997,335392.1099999997
2022-04-12 04:15:00,39829.0,2022-04-12 14:00:00,40180.4,351.4,435743.5099999997,335743.5099999997
2022-04-12 14:15:00,39829.8,2022-04-12 22:45:00,39809.3,20.5,435764.0099999997,335764.0099999997
2022-04-12 23:00:00,39882.5,2022-04-13 00:45:00,39917.0,34.5,435798.5099999997,335798.5099999997
2022-04-13 01:00:00,39762.0,2022-04-13 04:30:00,39962.0,-200.0,435598.5099999997,335598.5099999997
2022-04-13 04:45:00,40112.9,2022-04-13 11:30:00,39813.2,-299.7,435298.8099999997,335298.8099999997
2022-04-13 11:45:00,39697.7,2022-04-13 13:15:00,39814.4,-116.7,435182.1099999997,335182.1099999997
2022-04-13 13:30:00,40288.2,2022-04-14 04:00:00,41377.53,1089.33,436271.4399999997,336271.4399999997
2022-04-14 06:00:00,41183.7,2022-04-14 19:00:00,39525.8,1657.9,437929.33999999973,337929.33999999973
2022-04-14 22:00:00,39972.9,2022-04-15 12:45:00,40139.6,166.7,438096.03999999975,338096.03999999975
2022-04-15 13:00:00,40077.0,2022-04-15 14:30:00,40072.9,4.1,438100.1399999997,338100.1399999997
2022-04-15 14:45:00,40434.8,2022-04-15 15:45:00,40397.9,-36.9,438063.2399999997,338063.2399999997
2022-04-15 16:00:00,40267.3,2022-04-15 23:15:00,40446.6,-179.3,437883.9399999997,337883.9399999997
2022-04-15 23:30:00,40544.9,2022-04-16 02:45:00,40508.0,-36.9,437847.0399999997,337847.0399999997
2022-04-16 03:00:00,40429.2,2022-04-16 14:30:00,40455.7,-26.5,437820.5399999997,337820.5399999997
2022-04-16 14:45:00,40480.4,2022-04-16 15:00:00,40159.6,-302.92,437517.6199999997,337517.6199999997
2022-04-16 15:15:00,40188.2,2022-04-16 20:00:00,40170.1,18.1,437535.7199999997,337535.7199999997
2022-04-16 20:15:00,40194.2,2022-04-16 23:30:00,40467.0,272.8,437808.51999999967,337808.51999999967
2022-04-16 23:45:00,40361.0,2022-04-17 05:30:00,40289.9,71.1,437879.61999999965,337879.61999999965
2022-04-17 05:45:00,40345.9,2022-04-17 16:30:00,40394.9,49.0,437928.61999999965,337928.61999999965
2022-04-17 16:45:00,40175.2,2022-04-17 19:15:00,40098.0,77.2,438005.81999999966,338005.81999999966
2022-04-17 19:30:00,40146.1,2022-04-17 22:30:00,40131.9,-14.2,437991.61999999965,337991.61999999965
2022-04-17 22:45:00,39983.4,2022-04-18 06:15:00,38935.6,1047.8,439039.41999999963,339039.41999999963
2022-04-18 06:30:00,38993.3,2022-04-18 15:45:00,39239.2,245.9,439285.31999999966,339285.31999999966
2022-04-18 16:00:00,39071.8,2022-04-18 16:45:00,39441.0,-499.82,438785.49999999965,338785.49999999965
2022-04-18 17:00:00,40129.8,2022-04-18 17:00:00,40129.8,-669.25,438116.24999999965,338116.24999999965
2022-04-19 01:45:00,40731.0,2022-04-19 12:15:00,40882.1,-151.1,437965.1499999997,337965.1499999997
2022-04-19 12:30:00,40961.6,2022-04-19 16:45:00,41327.8,366.2,438331.3499999997,338331.3499999997
2022-04-19 17:00:00,41254.7,2022-04-19 23:30:00,41449.8,-195.1,438136.2499999997,338136.2499999997
2022-04-19 23:45:00,41472.9,2022-04-20 07:00:00,41446.6,-26.3,438109.9499999997,338109.9499999997
2022-04-20 07:15:00,41312.8,2022-04-20 09:15:00,41512.0,-199.2,437910.7499999997,337910.7499999997
2022-04-20 09:30:00,41579.1,2022-04-20 13:30:00,41690.9,111.8,438022.5499999997,338022.5499999997
2022-04-20 13:45:00,41580.9,2022-04-20 20:30:00,41280.7,300.2,438322.7499999997,338322.7499999997
2022-04-20 20:45:00,41395.2,2022-04-21 15:15:00,42455.9,1060.7,439383.4499999997,339383.4499999997
2022-04-21 15:30:00,42271.4,2022-04-21 22:30:00,39766.89,2504.51,441887.95999999973,341887.95999999973
2022-04-21 23:30:00,40441.6,2022-04-22 09:30:00,40340.0,-101.6,441786.35999999975,341786.35999999975
2022-04-22 09:45:00,40284.1,2022-04-22 22:15:00,39662.8,621.3,442407.65999999974,342407.65999999974
2022-04-22 22:30:00,39704.9,2022-04-23 02:30:00,39509.9,-195.0,442212.65999999974,342212.65999999974
2022-04-23 02:45:00,39478.6,2022-04-23 05:45:00,39540.0,-61.4,442151.2599999997,342151.2599999997
2022-04-23 06:00:00,39640.0,2022-04-23 18:15:00,39767.6,127.6,442278.8599999997,342278.8599999997
2022-04-23 18:30:00,39700.9,2022-04-23 21:45:00,39863.8,-235.19,442043.6699999997,342043.6699999997
2022-04-23 22:30:00,39864.9,2022-04-23 23:15:00,39772.7,-92.2,441951.4699999997,341951.4699999997
2022-04-23 23:30:00,39498.3,2022-04-24 00:00:00,39525.0,-26.7,441924.76999999967,341924.76999999967
2022-04-24 00:15:00,39621.3,2022-04-24 11:00:00,39690.8,69.5,441994.26999999967,341994.26999999967
2022-04-24 11:15:00,39574.4,2022-04-24 14:15:00,39458.0,116.4,442110.6699999997,342110.6699999997
2022-04-24 14:30:00,39699.2,2022-04-24 16:15:00,39558.9,-140.3,441970.3699999997,341970.3699999997
2022-04-24 16:30:00,39414.6,2022-04-24 17:45:00,39392.8,21.8,441992.1699999997,341992.1699999997
2022-04-24 18:00:00,39464.9,2022-04-24 23:45:00,39433.4,-31.5,441960.6699999997,341960.6699999997
2022-04-25 00:00:00,39255.0,2022-04-25 02:45:00,39066.6,188.4,442149.0699999997,342149.0699999997
2022-04-25 03:00:00,39141.9,2022-04-25 06:30:00,38870.2,-271.7,441877.3699999997,341877.3699999997
2022-04-25 06:45:00,38610.2,2022-04-25 11:15:00,38660.7,-50.5,441826.8699999997,341826.8699999997
2022-04-25 11:30:00,38759.1,2022-04-25 22:45:00,40573.59,1814.49,443641.3599999997,343641.3599999997
2022-04-26 09:30:00,40426.4,2022-04-26 19:30:00,37867.38,2559.02,446200.3799999997,346200.3799999997
2022-04-27 02:00:00,38324.1,2022-04-27 13:45:00,39317.2,993.1,447193.4799999997,347193.4799999997
2022-04-27 14:00:00,38605.1,2022-04-27 14:00:00,38605.1,-765.19,446428.2899999997,346428.2899999997
2022-04-27 16:15:00,39261.4,2022-04-28 05:00:00,39315.0,53.6,446481.88999999966,346481.88999999966
2022-04-28 05:15:00,39249.3,2022-04-28 07:45:00,39365.0,-386.2,446095.68999999965,346095.68999999965
2022-04-28 08:30:00,39610.1,2022-04-28 12:45:00,39543.2,-66.9,446028.78999999963,346028.78999999963
2022-04-28 13:00:00,39391.2,2022-04-28 14:45:00,39279.9,111.3,446140.0899999996,346140.0899999996
2022-04-28 15:00:00,40097.3,2022-04-28 15:00:00,40097.3,-821.5,445318.5899999996,345318.5899999996
2022-04-28 22:15:00,39688.8,2022-04-29 23:15:00,38560.0,1128.8,446447.3899999996,346447.3899999996
2022-04-29 23:30:00,38626.9,2022-04-30 11:45:00,38564.9,-62.0,446385.3899999996,346385.3899999996
2022-04-30 12:00:00,38553.0,2022-04-30 16:00:00,38478.9,74.1,446459.4899999996,346459.4899999996
2022-04-30 16:15:00,38531.4,2022-04-30 21:45:00,38284.4,-247.0,446212.4899999996,346212.4899999996
2022-04-30 22:00:00,38225.2,2022-05-01 01:45:00,37914.1,311.1,446523.58999999956,346523.58999999956
2022-05-01 02:00:00,37969.9,2022-05-01 18:00:00,38359.8,389.9,446913.4899999996,346913.4899999996
2022-05-01 18:15:00,38208.0,2022-05-01 20:30:00,37885.0,323.0,447236.4899999996,347236.4899999996
2022-05-01 20:45:00,38285.9,2022-05-02 10:15:00,38795.7,509.8,447746.2899999996,347746.2899999996
2022-05-02 10:30:00,38765.7,2022-05-02 21:15:00,38517.2,248.5,447994.7899999996,347994.7899999996
2022-05-02 21:30:00,38634.8,2022-05-03 00:30:00,38465.6,-169.2,447825.58999999956,347825.58999999956
2022-05-03 00:45:00,38412.1,2022-05-03 07:45:00,38553.1,-141.0,447684.58999999956,347684.58999999956
2022-05-03 08:00:00,38610.1,2022-05-03 10:15:00,38449.9,-160.2,447524.38999999955,347524.38999999955
2022-05-03 10:30:00,38404.4,2022-05-03 11:30:00,38425.8,-21.4,447502.9899999995,347502.9899999995
2022-05-03 11:45:00,38561.9,2022-05-03 13:30:00,38294.9,-340.36,447162.62999999954,347162.62999999954
2022-05-03 16:15:00,38163.0,2022-05-04 00:45:00,37882.6,280.4,447443.02999999956,347443.02999999956
2022-05-04 01:00:00,37894.8,2022-05-04 13:30:00,38924.4,1029.6,448472.62999999954,348472.62999999954
2022-05-04 13:45:00,38711.8,2022-05-04 16:00:00,39018.5,-306.7,448165.9299999995,348165.9299999995
2022-05-04 16:15:00,39318.6,2022-05-05 00:30:00,39673.7,355.1,448521.0299999995,348521.0299999995
2022-05-05 00:45:00,39657.5,2022-05-05 15:00:00,36402.74,3254.76,451775.7899999995,351775.7899999995
2022-05-05 15:15:00,37090.9,2022-05-05 18:00:00,36711.6,-379.3,451396.4899999995,351396.4899999995
2022-05-05 18:15:00,36156.4,2022-05-05 21:00:00,36360.8,-204.4,451192.0899999995,351192.0899999995
2022-05-05 21:15:00,36467.9,2022-05-06 07:00:00,36398.4,-69.5,451122.5899999995,351122.5899999995
2022-05-06 07:15:00,36352.7,2022-05-06 07:30:00,35897.9,454.8,451577.3899999995,351577.3899999995
2022-05-06 07:45:00,36359.3,2022-05-06 07:45:00,36359.3,-518.42,451058.9699999995,351058.9699999995
2022-05-06 10:45:00,35927.9,2022-05-06 14:45:00,36125.8,-197.9,450861.0699999995,350861.0699999995
2022-05-06 15:00:00,36188.5,2022-05-06 21:45:00,35935.3,-253.2,450607.8699999995,350607.8699999995
2022-05-06 22:00:00,35860.8,2022-05-07 08:30:00,35960.0,-99.2,450508.66999999946,350508.66999999946
2022-05-07 08:45:00,35991.1,2022-05-07 13:00:00,35882.2,-108.9,450399.76999999944,350399.76999999944
2022-05-07 13:15:00,35871.4,2022-05-07 22:45:00,35026.1,845.3,451245.0699999994,351245.0699999994
2022-05-07 23:00:00,35435.0,2022-05-08 00:30:00,35248.7,-186.3,451058.76999999944,351058.76999999944
2022-05-08 00:45:00,35103.3,2022-05-08 06:30:00,34691.6,411.7,451470.46999999945,351470.46999999945
2022-05-08 06:45:00,34771.5,2022-05-08 13:30:00,34578.1,-193.4,451277.0699999994,351277.0699999994
2022-05-08 13:45:00,34353.1,2022-05-08 18:15:00,34213.6,139.5,451416.5699999994,351416.5699999994
2022-05-08 18:30:00,34556.0,2022-05-08 22:00:00,34165.7,-390.3,451026.26999999944,351026.26999999944
2022-05-08 22:15:00,34149.4,2022-05-09 08:45:00,33666.1,483.3,451509.5699999994,351509.5699999994
2022-05-09 09:00:00,33721.0,2022-05-09 10:15:00,33250.6,-610.0,450899.5699999994,350899.5699999994
2022-05-09 10:30:00,33055.8,2022-05-10 02:00:00,30935.1,2120.7,453020.26999999944,353020.26999999944
2022-05-10 02:15:00,31294.3,2022-05-10 09:00:00,31864.0,569.7,453589.96999999945,353589.96999999945
2022-05-10 09:15:00,31455.4,2022-05-10 12:45:00,32153.2,-697.8,452892.16999999946,352892.16999999946
2022-05-10 13:00:00,32162.5,2022-05-10 14:15:00,31622.1,-540.4,452351.76999999944,352351.76999999944
2022-05-10 14:30:00,31273.0,2022-05-10 18:15:00,31616.5,-343.5,452008.26999999944,352008.26999999944
2022-05-10 18:30:00,31746.4,2022-05-10 20:30:00,31040.2,-772.26,451236.0099999994,351236.0099999994
2022-05-10 20:45:00,30996.5,2022-05-11 00:00:00,30975.5,21.0,451257.0099999994,351257.0099999994
2022-05-11 00:15:00,31218.6,2022-05-11 06:30:00,30978.8,-239.8,451017.20999999944,351017.20999999944
2022-05-11 06:45:00,30487.4,2022-05-11 08:30:00,30972.7,-485.3,450531.90999999945,350531.90999999945
2022-05-11 08:45:00,31395.0,2022-05-11 12:15:00,31559.9,164.9,450696.8099999995,350696.8099999995
2022-05-11 12:30:00,30231.3,2022-05-11 12:30:00,30231.3,-1314.65,449382.15999999945,349382.15999999945
2022-05-11 13:45:00,31223.0,2022-05-11 16:30:00,30658.1,-564.9,448817.2599999994,348817.2599999994
2022-05-11 16:45:00,30324.6,2022-05-11 23:45:00,29074.7,1249.9,450067.15999999945,350067.15999999945
2022-05-12 00:00:00,29427.0,2022-05-12 02:15:00,29121.4,-305.6,449761.5599999995,349761.5599999995
2022-05-12 02:30:00,28763.6,2022-05-12 10:15:00,28322.0,441.6,450203.15999999945,350203.15999999945
2022-05-12 10:30:00,28477.4,2022-05-12 18:15:00,28524.8,47.4,450250.5599999995,350250.5599999995
2022-05-12 18:30:00,28346.1,2022-05-12 23:15:00,28979.1,-633.0,449617.5599999995,349617.5599999995
2022-05-12 23:30:00,29148.7,2022-05-13 07:30:00,30338.1,1189.4,450806.9599999995,350806.9599999995
2022-05-13 07:45:00,30172.3,2022-05-13 14:15:00,30866.9,-785.73,450021.2299999995,350021.2299999995
2022-05-13 22:00:00,30092.6,2022-05-13 22:45:00,29802.9,-289.7,449731.5299999995,349731.5299999995
2022-05-13 23:00:00,29388.6,2022-05-14 16:30:00,29136.3,252.3,449983.8299999995,349983.8299999995
2022-05-14 16:45:00,29335.4,2022-05-15 02:15:00,29787.3,451.9,450435.7299999995,350435.7299999995
2022-05-15 02:30:00,29765.0,2022-05-15 06:30:00,29749.9,15.1,450450.8299999995,350450.8299999995
2022-05-15 06:45:00,29951.3,2022-05-15 08:30:00,29692.8,-258.5,450192.3299999995,350192.3299999995
2022-05-15 08:45:00,29577.5,2022-05-15 11:15:00,29968.4,-390.9,449801.42999999947,349801.42999999947
2022-05-15 11:30:00,30101.3,2022-05-15 14:00:00,30019.1,-82.2,449719.22999999946,349719.22999999946
2022-05-15 14:15:00,29904.7,2022-05-15 18:15:00,30030.1,-125.4,449593.82999999943,349593.82999999943
2022-05-15 18:30:00,30372.8,2022-05-16 01:15:00,30919.9,547.1,450140.9299999994,350140.9299999994
2022-05-16 01:30:00,30745.0,2022-05-16 10:30:00,29919.8,825.2,450966.1299999994,350966.1299999994
2022-05-16 10:45:00,30161.8,2022-05-16 14:30:00,29618.1,-543.7,450422.4299999994,350422.4299999994
2022-05-16 14:45:00,29469.6,2022-05-16 17:45:00,29715.0,-245.4,450177.0299999994,350177.0299999994
2022-05-16 18:00:00,29853.2,2022-05-17 11:15:00,30413.4,560.2,450737.2299999994,350737.2299999994
2022-05-17 11:30:00,30326.8,2022-05-17 19:00:00,30093.4,233.4,450970.6299999994,350970.6299999994
2022-05-17 19:15:00,30202.3,2022-05-18 01:30:00,30318.5,116.2,451086.82999999943,351086.82999999943
2022-05-18 01:45:00,30115.3,2022-05-18 20:45:00,29218.1,897.2,451984.02999999945,351984.02999999945
2022-05-18 21:00:00,29283.8,2022-05-18 23:00:00,29026.0,-257.8,451726.22999999946,351726.22999999946
2022-05-18 23:15:00,28823.6,2022-05-19 03:15:00,29178.7,-355.1,451371.1299999995,351371.1299999995
2022-05-19 03:30:00,29217.1,2022-05-19 08:30:00,29110.2,-106.9,451264.22999999946,351264.22999999946
2022-05-19 08:45:00,28957.9,2022-05-19 11:00:00,29164.0,-206.1,451058.1299999995,351058.1299999995
2022-05-19 11:15:00,29294.2,2022-05-19 19:30:00,30007.4,713.2,451771.3299999995,351771.3299999995
2022-05-19 19:45:00,29959.2,2022-05-19 21:15:00,30271.1,-514.83,451256.4999999995,351256.4999999995
2022-05-20 01:15:00,30356.5,2022-05-20 02:45:00,30328.0,-28.5,451227.9999999995,351227.9999999995
2022-05-20 03:00:00,30231.7,2022-05-20 07:15:00,30181.0,50.7,451278.6999999995,351278.6999999995
2022-05-20 07:30:00,30256.3,2022-05-20 14:00:00,30120.3,-136.0,451142.6999999995,351142.6999999995
2022-05-20 14:15:00,29930.3,2022-05-20 20:00:00,29241.1,689.2,451831.8999999995,351831.8999999995
2022-05-20 20:15:00,29316.0,2022-05-21 09:00:00,29333.3,17.3,451849.1999999995,351849.1999999995
2022-05-21 09:15:00,29248.1,2022-05-21 15:30:00,29369.6,-121.5,451727.6999999995,351727.6999999995
2022-05-21 15:45:00,29531.5,2022-05-21 21:30:00,29435.5,-96.0,451631.6999999995,351631.6999999995
2022-05-21 21:45:00,29341.3,2022-05-22 07:30:00,29381.3,-40.0,451591.6999999995,351591.6999999995
2022-05-22 07:45:00,29430.1,2022-05-22 11:30:00,29956.7,526.6,452118.29999999946,352118.29999999946
2022-05-22 11:45:00,29891.1,2022-05-22 17:00:00,29982.2,-91.1,452027.1999999995,352027.1999999995
2022-05-22 17:15:00,30092.8,2022-05-23 01:45:00,30212.4,119.6,452146.79999999946,352146.79999999946
2022-05-23 02:00:00,30091.8,2022-05-23 05:45:00,30295.9,-204.1,451942.6999999995,351942.6999999995
2022-05-23 06:00:00,30379.9,2022-05-23 13:45:00,30310.9,-69.0,451873.6999999995,351873.6999999995
2022-05-23 14:00:00,30114.7,2022-05-23 14:45:00,30246.2,-131.5,451742.1999999995,351742.1999999995
2022-05-23 15:00:00,30457.2,2022-05-23 18:00:00,30110.1,-347.1,451395.0999999995,351395.0999999995
2022-05-23 18:15:00,30072.3,2022-05-24 02:15:00,29205.0,867.3,452262.3999999995,352262.3999999995
2022-05-24 02:30:00,29229.6,2022-05-24 08:30:00,29261.2,31.6,452293.9999999995,352293.9999999995
2022-05-24 08:45:00,29146.4,2022-05-24 15:00:00,29013.4,133.0,452426.9999999995,352426.9999999995
2022-05-24 15:15:00,29098.5,2022-05-24 18:30:00,29264.0,165.5,452592.4999999995,352592.4999999995
2022-05-24 18:45:00,29163.1,2022-05-24 20:45:00,29449.3,-286.2,452306.29999999946,352306.29999999946
2022-05-24 21:00:00,29538.6,2022-05-25 05:30:00,29953.3,414.7,452720.9999999995,352720.9999999995
2022-05-25 05:45:00,29866.4,2022-05-25 13:45:00,29697.1,169.3,452890.29999999946,352890.29999999946
2022-05-25 14:00:00,29845.6,2022-05-25 23:15:00,29709.1,-136.5,452753.79999999946,352753.79999999946
2022-05-25 23:30:00,29565.0,2022-05-26 03:15:00,29735.3,-170.3,452583.4999999995,352583.4999999995
2022-05-26 03:30:00,29812.5,2022-05-26 08:00:00,29609.7,-202.8,452380.6999999995,352380.6999999995
2022-05-26 08:15:00,29186.3,2022-05-26 08:15:00,29186.3,-390.16,451990.5399999995,351990.5399999995
2022-05-26 13:45:00,28787.6,2022-05-26 23:30:00,29426.4,638.8,452629.3399999995,352629.3399999995
2022-05-26 23:45:00,29194.0,2022-05-27 12:15:00,28994.1,199.9,452829.2399999995,352829.2399999995
2022-05-27 12:30:00,29237.3,2022-05-27 14:30:00,28919.2,-318.1,452511.13999999955,352511.13999999955
2022-05-27 14:45:00,28778.2,2022-05-27 19:30:00,28581.2,197.0,452708.13999999955,352708.13999999955
2022-05-27 19:45:00,28870.0,2022-05-27 23:15:00,28706.2,-163.8,452544.33999999956,352544.33999999956
2022-05-27 23:30:00,28590.4,2022-05-28 05:00:00,28826.8,-236.4,452307.93999999954,352307.93999999954
2022-05-28 05:15:00,28836.7,2022-05-28 14:15:00,28994.1,157.4,452465.33999999956,352465.33999999956
2022-05-28 14:30:00,28989.8,2022-05-28 19:30:00,28972.1,17.7,452483.0399999996,352483.0399999996
2022-05-28 19:45:00,29013.5,2022-05-29 00:45:00,28991.9,-21.6,452461.4399999996,352461.4399999996
2022-05-29 01:00:00,28961.9,2022-05-29 05:15:00,28987.0,-25.1,452436.3399999996,352436.3399999996
2022-05-29 05:30:00,29000.0,2022-05-29 09:00:00,29023.3,23.3,452459.6399999996,352459.6399999996
2022-05-29 09:15:00,28981.8,2022-05-29 10:15:00,29099.6,-223.48,452236.1599999996,352236.1599999996
2022-05-29 11:45:00,29204.0,2022-05-29 15:00:00,29238.2,34.2,452270.35999999964,352270.35999999964
2022-05-29 15:15:00,29209.8,2022-05-29 22:00:00,29241.2,-31.4,452238.9599999996,352238.9599999996
2022-05-29 22:15:00,29410.3,2022-05-29 23:45:00,29452.8,42.5,452281.4599999996,352281.4599999996
2022-05-30 00:00:00,29335.9,2022-05-30 01:15:00,29440.6,-104.7,452176.7599999996,352176.7599999996
2022-05-30 01:30:00,29659.9,2022-05-30 10:30:00,30645.4,985.5,453162.2599999996,353162.2599999996
2022-05-30 10:45:00,30594.7,2022-05-30 17:00:00,30630.6,-35.9,453126.3599999996,353126.3599999996
2022-05-30 17:15:00,30731.8,2022-05-30 21:15:00,31679.8,948.0,454074.3599999996,354074.3599999996
2022-05-30 21:30:00,31597.2,2022-05-31 10:45:00,31656.6,-59.4,454014.95999999956,354014.95999999956
2022-05-31 11:00:00,31733.6,2022-05-31 13:15:00,31835.3,101.7,454116.65999999957,354116.65999999957
2022-05-31 13:30:00,31366.9,2022-05-31 13:30:00,31366.9,-459.91,453656.7499999996,353656.7499999996
2022-05-31 15:30:00,31771.0,2022-05-31 18:15:00,32059.1,288.1,453944.84999999957,353944.84999999957
2022-05-31 18:30:00,31807.8,2022-06-01 09:00:00,31610.9,196.9,454141.7499999996,354141.7499999996
2022-06-01 09:15:00,31678.4,2022-06-01 14:00:00,31526.9,-151.5,453990.2499999996,353990.2499999996
2022-06-01 14:15:00,31346.0,2022-06-02 00:00:00,29687.79,1658.21,455648.4599999996,355648.4599999996
2022-06-02 02:00:00,29839.5,2022-06-02 12:45:00,30076.5,237.0,455885.4599999996,355885.4599999996
2022-06-02 13:00:00,29741.2,2022-06-02 13:15:00,29828.1,-86.9,455798.5599999996,355798.5599999996
2022-06-02 13:30:00,30202.2,2022-06-03 04:30:00,30476.8,274.6,456073.15999999957,356073.15999999957
2022-06-03 04:45:00,30410.7,2022-06-03 19:30:00,29566.9,843.8,456916.95999999956,356916.95999999956
2022-06-03 19:45:00,29560.5,2022-06-04 00:45:00,29697.9,137.4,457054.3599999996,357054.3599999996
2022-06-04 01:00:00,29576.4,2022-06-04 05:30:00,29656.2,-79.8,456974.5599999996,356974.5599999996
2022-06-04 05:45:00,29668.5,2022-06-04 12:00:00,29633.6,-34.9,456939.65999999957,356939.65999999957
2022-06-04 12:15:00,29592.2,2022-06-04 14:00:00,29529.8,62.4,457002.0599999996,357002.0599999996
2022-06-04 14:15:00,29721.2,2022-06-04 16:45:00,29737.1,15.9,457017.9599999996,357017.9599999996
2022-06-04 17:00:00,29662.0,2022-06-04 21:15:00,29744.5,-82.5,456935.4599999996,356935.4599999996
2022-06-04 21:30:00,29811.9,2022-06-05 00:30:00,29782.8,-29.1,456906.35999999964,356906.35999999964
2022-06-05 00:45:00,29725.0,2022-06-05 12:00:00,29681.9,43.1,456949.4599999996,356949.4599999996
2022-06-05 12:15:00,29746.3,2022-06-05 16:00:00,30039.7,293.4,457242.85999999964,357242.85999999964
2022-06-05 16:15:00,29848.9,2022-06-05 19:45:00,30036.3,-187.4,457055.4599999996,357055.4599999996
2022-06-05 20:00:00,30085.2,2022-06-05 21:15:00,29845.1,-282.19,456773.2699999996,356773.2699999996
2022-06-06 15:15:00,31252.9,2022-06-06 20:45:00,31454.6,-201.7,456571.5699999996,356571.5699999996
2022-06-06 21:00:00,31504.9,2022-06-06 23:45:00,31361.2,-143.7,456427.8699999996,356427.8699999996
2022-06-07 00:00:00,31233.9,2022-06-07 02:30:00,29202.13,2031.77,458459.6399999996,358459.6399999996
2022-06-07 07:45:00,29569.0,2022-06-07 19:45:00,31252.09,1683.09,460142.72999999963,360142.72999999963
2022-06-08 03:00:00,30898.9,2022-06-08 06:30:00,30441.3,457.6,460600.3299999996,360600.3299999996
2022-06-08 06:45:00,30519.8,2022-06-08 12:30:00,30201.9,-317.9,460282.4299999996,360282.4299999996
2022-06-08 12:45:00,30127.5,2022-06-08 13:30:00,30481.9,-538.47,459743.9599999996,359743.9599999996
2022-06-08 13:45:00,30754.5,2022-06-08 16:15:00,30425.1,-329.4,459414.5599999996,359414.5599999996
2022-06-08 16:30:00,30225.5,2022-06-08 21:15:00,30289.5,-64.0,459350.5599999996,359350.5599999996
2022-06-08 21:30:00,30332.6,2022-06-09 00:00:00,30184.2,-148.4,459202.15999999957,359202.15999999957
2022-06-09 00:15:00,30128.3,2022-06-09 05:00:00,30308.5,-279.46,458922.69999999955,358922.69999999955
2022-06-09 05:15:00,30366.6,2022-06-09 11:15:00,30413.4,46.8,458969.49999999953,358969.49999999953
2022-06-09 11:30:00,30375.2,2022-06-10 01:00:00,29780.3,594.9,459564.39999999956,359564.39999999956
2022-06-10 01:15:00,29954.2,2022-06-10 06:45:00,30087.8,133.6,459697.99999999953,359697.99999999953
2022-06-10 07:00:00,30069.3,2022-06-10 21:15:00,29162.4,906.9,460604.89999999956,360604.89999999956
2022-06-10 21:30:00,29212.4,2022-06-11 07:45:00,29309.0,96.6,460701.49999999953,360701.49999999953
2022-06-11 08:00:00,29250.1,2022-06-11 09:00:00,28964.2,285.9,460987.39999999956,360987.39999999956
2022-06-11 09:15:00,29054.1,2022-06-11 11:00:00,28930.5,-123.6,460863.7999999996,360863.7999999996
2022-06-11 11:15:00,28782.2,2022-06-11 18:30:00,28590.1,192.1,461055.89999999956,361055.89999999956
2022-06-11 18:45:00,28598.7,2022-06-11 23:15:00,28470.1,-128.6,460927.2999999996,360927.2999999996
2022-06-11 23:30:00,28327.3,2022-06-12 08:00:00,27520.0,807.3,461734.59999999957,361734.59999999957
2022-06-12 08:15:00,27623.2,2022-06-12 13:00:00,27432.9,-190.3,461544.2999999996,361544.2999999996
2022-06-12 13:15:00,27340.3,2022-06-12 14:15:00,27442.8,-102.5,461441.7999999996,361441.7999999996
2022-06-12 14:30:00,27508.2,2022-06-12 18:45:00,27896.9,388.7,461830.4999999996,361830.4999999996
2022-06-12 19:00:00,27834.4,2022-06-13 03:00:00,25094.01,2740.39,464570.8899999996,364570.8899999996
2022-06-13 04:15:00,26079.3,2022-06-13 07:00:00,25352.2,-727.1,463843.78999999963,363843.78999999963
2022-06-13 07:15:00,25162.3,2022-06-13 20:00:00,23389.6,1772.7,465616.48999999964,365616.48999999964
2022-06-13 20:15:00,23592.5,2022-06-13 22:00:00,22978.8,-613.7,465002.78999999963,365002.78999999963
2022-06-13 22:15:00,22909.6,2022-06-14 03:30:00,21932.2,977.4,465980.18999999965,365980.18999999965
2022-06-14 03:45:00,22106.5,2022-06-14 09:15:00,22450.9,344.4,466324.5899999997,366324.5899999997
2022-06-14 09:30:00,22408.7,2022-06-14 15:30:00,22649.7,-241.0,466083.5899999997,366083.5899999997
2022-06-14 15:45:00,22672.6,2022-06-14 20:00:00,22169.0,-503.6,465579.9899999997,365579.9899999997
2022-06-14 20:15:00,21919.6,2022-06-14 23:15:00,21979.6,-60.0,465519.9899999997,365519.9899999997
2022-06-14 23:30:00,22146.8,2022-06-15 03:15:00,21710.8,-436.0,465083.9899999997,365083.9899999997
2022-06-15 03:30:00,21535.9,2022-06-15 11:00:00,20610.7,925.2,466009.1899999997,366009.1899999997
2022-06-15 11:15:00,20960.3,2022-06-15 16:15:00,21198.1,237.8,466246.9899999997,366246.9899999997
2022-06-15 16:30:00,20813.3,2022-06-15 18:15:00,20732.1,81.2,466328.1899999997,366328.1899999997
2022-06-15 18:30:00,21930.0,2022-06-15 18:30:00,21930.0,-1475.3,464852.8899999997,364852.8899999997
2022-06-16 03:30:00,22205.9,2022-06-16 22:45:00,20422.45,1783.45,466636.33999999973,366636.33999999973
2022-06-17 01:45:00,20866.1,2022-06-17 03:30:00,20500.4,-365.7,466270.6399999997,366270.6399999997
2022-06-17 03:45:00,20369.0,2022-06-17 05:15:00,20730.3,-361.3,465909.33999999973,365909.33999999973
2022-06-17 05:30:00,20851.2,2022-06-17 12:00:00,20988.6,137.4,466046.73999999976,366046.73999999976
2022-06-17 12:15:00,20896.5,2022-06-18 06:45:00,19365.47,1531.03,467577.7699999998,367577.7699999998
2022-06-18 10:15:00,19434.1,2022-06-18 14:30:00,19171.8,-262.3,467315.4699999998,367315.4699999998
2022-06-18 14:45:00,19070.5,2022-06-18 21:00:00,17989.2,1081.3,468396.7699999998,368396.7699999998
2022-06-18 21:15:00,18664.4,2022-06-19 01:15:00,18843.5,179.1,468575.86999999976,368575.86999999976
2022-06-19 01:30:00,18614.4,2022-06-19 08:15:00,18452.9,161.5,468737.36999999976,368737.36999999976
2022-06-19 08:30:00,18583.1,2022-06-19 13:30:00,19429.5,846.4,469583.7699999998,369583.7699999998
2022-06-19 13:45:00,19172.9,2022-06-19 15:30:00,19700.0,-736.6,468847.1699999998,368847.1699999998
2022-06-19 18:45:00,20237.4,2022-06-20 00:30:00,20201.4,-36.0,468811.1699999998,368811.1699999998
2022-06-20 00:45:00,20054.2,2022-06-20 07:45:00,20076.7,-22.5,468788.6699999998,368788.6699999998
2022-06-20 08:00:00,20282.8,2022-06-20 16:15:00,20521.4,238.6,469027.2699999998,369027.2699999998
2022-06-20 16:30:00,20386.0,2022-06-20 20:30:00,20340.4,45.6,469072.86999999976,369072.86999999976
2022-06-20 20:45:00,20446.0,2022-06-21 11:30:00,21019.9,573.9,469646.7699999998,369646.7699999998
2022-06-21 11:45:00,20953.2,2022-06-21 13:15:00,21133.8,-180.6,469466.1699999998,369466.1699999998
2022-06-21 13:30:00,21525.7,2022-06-21 17:15:00,21401.6,-124.1,469342.06999999983,369342.06999999983
2022-06-21 17:30:00,21259.7,2022-06-22 09:30:00,20372.3,887.4,470229.46999999986,370229.46999999986
2022-06-22 09:45:00,20415.7,2022-06-22 15:15:00,20455.3,39.6,470269.06999999983,370269.06999999983
2022-06-22 15:30:00,20306.1,2022-06-23 00:00:00,20103.6,202.5,470471.56999999983,370471.56999999983
2022-06-23 00:15:00,20330.9,2022-06-23 03:45:00,20202.9,-128.0,470343.56999999983,370343.56999999983
2022-06-23 04:00:00,20190.1,2022-06-23 06:15:00,20413.4,-223.3,470120.26999999984,370120.26999999984
2022-06-23 06:30:00,20578.8,2022-06-23 13:30:00,20489.3,-89.5,470030.76999999984,370030.76999999984
2022-06-23 13:45:00,20452.1,2022-06-23 18:45:00,20418.9,33.2,470063.96999999986,370063.96999999986
2022-06-23 19:00:00,20507.1,2022-06-23 21:30:00,20727.6,220.5,470284.46999999986,370284.46999999986
2022-06-23 21:45:00,20676.4,2022-06-23 22:30:00,21072.6,-463.1,469821.3699999999,369821.3699999999
2022-06-23 23:15:00,21141.2,2022-06-24 04:15:00,21086.8,-54.4,469766.96999999986,369766.96999999986
2022-06-24 04:30:00,21007.9,2022-06-24 11:00:00,21047.7,-39.8,469727.16999999987,369727.16999999987
2022-06-24 11:15:00,21142.6,2022-06-24 14:45:00,21118.1,-24.5,469702.66999999987,369702.66999999987
2022-06-24 15:00:00,21013.5,2022-06-24 19:30:00,21165.9,-152.4,469550.26999999984,369550.26999999984
2022-06-24 19:45:00,21241.9,2022-06-25 02:15:00,21230.9,-11.0,469539.26999999984,369539.26999999984
2022-06-25 02:30:00,21209.7,2022-06-25 06:45:00,21296.9,-87.2,469452.06999999983,369452.06999999983
2022-06-25 07:00:00,21455.0,2022-06-25 11:15:00,21452.8,-2.2,469449.8699999998,369449.8699999998
2022-06-25 11:30:00,21368.8,2022-06-25 18:30:00,21115.0,253.8,469703.6699999998,369703.6699999998
2022-06-25 18:45:00,21226.1,2022-06-26 02:00:00,21361.5,135.4,469839.06999999983,369839.06999999983
2022-06-26 02:15:00,21351.8,2022-06-26 11:15:00,21404.2,-52.4,469786.6699999998,369786.6699999998
2022-06-26 11:30:00,21522.0,2022-06-26 12:30:00,21620.2,98.2,469884.8699999998,369884.8699999998
2022-06-26 12:45:00,21447.3,2022-06-26 20:30:00,21295.9,151.4,470036.26999999984,370036.26999999984
2022-06-26 20:45:00,21388.9,2022-06-26 22:00:00,21297.9,-91.0,469945.26999999984,369945.26999999984
2022-06-26 22:15:00,21083.8,2022-06-27 04:00:00,21165.3,-81.5,469863.76999999984,369863.76999999984
2022-06-27 04:15:00,21207.5,2022-06-27 11:30:00,21360.0,152.5,470016.26999999984,370016.26999999984
2022-06-27 11:45:00,21298.2,2022-06-27 18:00:00,20734.3,563.9,470580.16999999987,370580.16999999987
2022-06-27 18:15:00,20871.2,2022-06-28 01:00:00,20788.9,-82.3,470497.8699999999,370497.8699999999
2022-06-28 01:15:00,20650.9,2022-06-28 05:00:00,20742.9,-92.0,470405.8699999999,370405.8699999999
2022-06-28 05:15:00,20787.1,2022-06-28 14:00:00,20959.1,172.0,470577.8699999999,370577.8699999999
2022-06-28 14:15:00,20830.0,2022-06-29 18:00:00,20089.0,741.0,471318.8699999999,371318.8699999999
2022-06-29 18:15:00,20103.8,2022-06-29 22:45:00,20204.8,101.0,471419.8699999999,371419.8699999999
2022-06-29 23:00:00,20117.0,2022-06-30 11:15:00,19033.9,1083.1,472502.96999999986,372502.96999999986
2022-06-30 15:00:00,19145.0,2022-06-30 18:30:00,18978.3,-166.7,472336.26999999984,372336.26999999984
2022-06-30 18:45:00,18962.1,2022-06-30 22:45:00,18885.0,77.1,472413.3699999998,372413.3699999998
2022-06-30 23:00:00,18962.4,2022-07-01 02:30:00,20328.0,1365.6,473778.9699999998,373778.9699999998
2022-07-01 02:45:00,20292.4,2022-07-01 13:15:00,19293.0,999.4,474778.3699999998,374778.3699999998
2022-07-01 13:30:00,19460.1,2022-07-01 19:00:00,19396.4,-63.7,474714.6699999998,374714.6699999998
2022-07-01 19:15:00,19303.7,2022-07-01 20:15:00,19584.6,-372.2,474342.4699999998,374342.4699999998
2022-07-02 10:30:00,19215.8,2022-07-02 15:00:00,19269.9,54.1,474396.5699999998,374396.5699999998
2022-07-02 15:15:00,19186.6,2022-07-02 18:45:00,19310.0,-200.16,474196.4099999998,374196.4099999998
2022-07-02 22:15:00,19343.5,2022-07-03 00:30:00,19214.0,-183.32,474013.0899999998,374013.0899999998
2022-07-03 01:30:00,19189.2,2022-07-03 04:45:00,19234.1,-44.9,473968.18999999977,373968.18999999977
2022-07-03 05:00:00,19184.0,2022-07-03 05:00:00,19184.0,0.0,473968.18999999977,373968.18999999977
2022-07-03 05:15:00,19085.1,2022-07-03 16:15:00,19085.1,0.0,473968.18999999977,373968.18999999977
2022-07-03 16:30:00,19130.2,2022-07-03 20:45:00,19433.5,303.3,474271.48999999976,374271.48999999976
2022-07-03 21:00:00,19343.8,2022-07-04 09:00:00,19147.1,196.7,474468.18999999977,374468.18999999977
2022-07-04 09:15:00,19222.2,2022-07-04 13:15:00,19689.9,467.7,474935.8899999998,374935.8899999998
2022-07-04 13:30:00,19536.4,2022-07-04 15:00:00,19870.0,-379.61,474556.2799999998,374556.2799999998
2022-07-04 17:15:00,19970.9,2022-07-04 21:00:00,19789.9,-181.0,474375.2799999998,374375.2799999998
2022-07-04 21:15:00,19773.8,2022-07-04 22:30:00,20016.5,-242.7,474132.5799999998,374132.5799999998
2022-07-04 22:45:00,20153.0,2022-07-05 07:45:00,20207.7,54.7,474187.2799999998,374187.2799999998
2022-07-05 08:00:00,20103.6,2022-07-05 17:00:00,19608.1,495.5,474682.7799999998,374682.7799999998
2022-07-05 17:15:00,19668.2,2022-07-05 22:00:00,20358.0,689.8,475372.5799999998,375372.5799999998
2022-07-05 22:15:00,20265.0,2022-07-06 03:45:00,19940.4,324.6,475697.17999999976,375697.17999999976
2022-07-06 04:00:00,20244.8,2022-07-07 02:15:00,20431.0,186.2,475883.3799999998,375883.3799999998
2022-07-07 02:30:00,20400.9,2022-07-07 07:45:00,20432.8,-31.9,475851.47999999975,375851.47999999975
2022-07-07 08:00:00,20439.8,2022-07-07 13:00:00,20439.3,-0.5,475850.97999999975,375850.97999999975
2022-07-07 13:15:00,20390.0,2022-07-07 14:00:00,20589.9,-233.25,475617.72999999975,375617.72999999975
2022-07-07 14:15:00,20713.6,2022-07-08 01:00:00,21707.36,993.76,476611.48999999976,376611.48999999976
2022-07-08 02:15:00,21912.2,2022-07-08 14:30:00,21643.3,268.9,476880.3899999998,376880.3899999998
2022-07-08 14:45:00,21754.9,2022-07-08 23:30:00,21881.3,126.4,477006.7899999998,377006.7899999998
2022-07-08 23:45:00,21587.9,2022-07-09 07:00:00,21643.7,-55.8,476950.9899999998,376950.9899999998
2022-07-09 07:15:00,21655.4,2022-07-09 11:30:00,21693.6,38.2,476989.1899999998,376989.1899999998
2022-07-09 11:45:00,21437.4,2022-07-09 13:00:00,21566.3,-128.9,476860.2899999998,376860.2899999998
2022-07-09 13:15:00,21590.9,2022-07-09 18:45:00,21744.0,153.1,477013.3899999998,377013.3899999998
2022-07-09 19:00:00,21538.1,2022-07-10 05:30:00,21345.3,192.8,477206.18999999977,377206.18999999977
2022-07-10 05:45:00,21350.0,2022-07-10 11:00:00,21241.3,-108.7,477097.48999999976,377097.48999999976
2022-07-10 11:15:00,21205.1,2022-07-10 17:15:00,20895.1,310.0,477407.48999999976,377407.48999999976
2022-07-10 17:30:00,20923.3,2022-07-10 21:45:00,21028.7,105.4,477512.8899999998,377512.8899999998
2022-07-10 22:00:00,20823.2,2022-07-11 08:45:00,20522.6,300.6,477813.48999999976,377813.48999999976
2022-07-11 09:00:00,20586.2,2022-07-11 13:30:00,20515.8,-70.4,477743.08999999973,377743.08999999973
2022-07-11 13:45:00,20367.1,2022-07-11 17:00:00,20532.6,-165.5,477577.58999999973,377577.58999999973
2022-07-11 17:15:00,20579.9,2022-07-11 20:15:00,20476.2,-103.7,477473.8899999997,377473.8899999997
2022-07-11 20:30:00,20465.5,2022-07-12 04:45:00,19995.7,469.8,477943.6899999997,377943.6899999997
2022-07-12 05:00:00,20003.2,2022-07-12 06:45:00,19837.4,-165.8,477777.8899999997,377777.8899999997
2022-07-12 07:00:00,19689.2,2022-07-12 12:00:00,19800.6,-111.4,477666.4899999997,377666.4899999997
2022-07-12 12:15:00,19896.9,2022-07-12 18:30:00,19791.7,-105.2,477561.2899999997,377561.2899999997
2022-07-12 18:45:00,19723.1,2022-07-13 02:30:00,19487.1,236.0,477797.2899999997,377797.2899999997
2022-07-13 02:45:00,19497.9,2022-07-13 12:15:00,20040.8,542.9,478340.1899999997,378340.1899999997
2022-07-13 12:30:00,19140.0,2022-07-13 12:30:00,19140.0,-574.11,477766.0799999997,377766.0799999997
2022-07-13 14:30:00,19532.1,2022-07-13 20:00:00,19697.5,165.4,477931.47999999975,377931.47999999975
2022-07-13 20:15:00,19606.5,2022-07-13 22:00:00,19896.1,-421.49,477509.98999999976,377509.98999999976
2022-07-13 23:15:00,20072.4,2022-07-14 04:30:00,20122.1,49.7,477559.68999999977,377559.68999999977
2022-07-14 04:45:00,20076.3,2022-07-14 14:45:00,19884.9,191.4,477751.0899999998,377751.0899999998
2022-07-14 15:00:00,20026.4,2022-07-14 21:30:00,20547.0,520.6,478271.68999999977,378271.68999999977
2022-07-14 21:45:00,20471.0,2022-07-15 01:45:00,20620.1,-149.1,478122.5899999998,378122.5899999998
2022-07-15 02:00:00,20738.4,2022-07-15 02:30:00,20594.2,-144.2,477978.3899999998,377978.3899999998
2022-07-15 02:45:00,20480.9,2022-07-15 07:00:00,20675.8,-194.9,477783.48999999976,377783.48999999976
2022-07-15 07:15:00,20848.9,2022-07-15 15:45:00,20785.1,-63.8,477719.68999999977,377719.68999999977
2022-07-15 16:00:00,20758.0,2022-07-15 18:15:00,20847.3,-89.3,477630.3899999998,377630.3899999998
2022-07-15 18:30:00,20966.9,2022-07-15 22:00:00,20918.5,-48.4,477581.98999999976,377581.98999999976
2022-07-15 22:15:00,20850.2,2022-07-16 10:00:00,20627.5,222.7,477804.68999999977,377804.68999999977
2022-07-16 10:15:00,20657.7,2022-07-16 19:30:00,21244.5,586.8,478391.48999999976,378391.48999999976
2022-07-16 19:45:00,21184.3,2022-07-16 21:00:00,21140.3,44.0,478435.48999999976,378435.48999999976
2022-07-16 21:15:00,21324.1,2022-07-17 09:00:00,21489.1,165.0,478600.48999999976,378600.48999999976
2022-07-17 09:15:00,21294.2,2022-07-18 02:00:00,20959.9,334.3,478934.78999999975,378934.78999999975
2022-07-18 02:15:00,21012.4,2022-07-18 11:15:00,22277.08,1264.68,480199.46999999974,380199.46999999974
2022-07-18 12:00:00,22059.1,2022-07-18 15:30:00,22337.5,-278.4,479921.0699999997,379921.0699999997
2022-07-18 15:45:00,22674.2,2022-07-18 16:15:00,22291.9,-382.3,479538.7699999997,379538.7699999997
2022-07-18 16:30:00,22159.3,2022-07-18 22:45:00,21782.9,376.4,479915.16999999975,379915.16999999975
2022-07-18 23:00:00,22097.9,2022-07-19 01:15:00,22293.1,195.2,480110.36999999976,380110.36999999976
2022-07-19 01:30:00,22116.3,2022-07-19 10:15:00,21851.9,264.4,480374.7699999998,380374.7699999998
2022-07-19 10:30:00,22040.5,2022-07-19 23:45:00,23385.9,1345.4,481720.1699999998,381720.1699999998
2022-07-20 00:00:00,23211.4,2022-07-20 03:15:00,23460.6,-249.2,481470.9699999998,381470.9699999998
2022-07-20 03:30:00,23470.2,2022-07-20 07:30:00,23476.9,6.7,481477.6699999998,381477.6699999998
2022-07-20 07:45:00,23376.7,2022-07-20 10:15:00,23707.6,-467.83,481009.8399999998,381009.8399999998
2022-07-20 12:00:00,23763.0,2022-07-20 16:15:00,23851.5,88.5,481098.3399999998,381098.3399999998
2022-07-20 16:30:00,23626.2,2022-07-20 21:15:00,23331.8,294.4,481392.7399999998,381392.7399999998
2022-07-20 21:30:00,23660.0,2022-07-21 00:15:00,23269.0,-391.0,481001.7399999998,381001.7399999998
2022-07-21 00:30:00,23154.8,2022-07-21 09:30:00,22949.3,205.5,481207.2399999998,381207.2399999998
2022-07-21 09:45:00,23002.3,2022-07-21 10:45:00,22865.3,-137.0,481070.2399999998,381070.2399999998
2022-07-21 11:00:00,22697.4,2022-07-21 15:45:00,22633.7,63.7,481133.9399999998,381133.9399999998
2022-07-21 16:00:00,22902.5,2022-07-22 02:30:00,23050.9,148.4,481282.33999999985,381282.33999999985
2022-07-22 02:45:00,22977.8,2022-07-22 05:30:00,23082.6,-104.8,481177.53999999986,381177.53999999986
2022-07-22 05:45:00,23136.8,2022-07-22 15:15:00,23383.1,246.3,481423.83999999985,381423.83999999985
2022-07-22 15:30:00,23254.6,2022-07-23 01:15:00,22796.5,458.1,481881.9399999998,381881.9399999998
2022-07-23 01:30:00,22840.3,2022-07-23 08:30:00,22838.9,-1.4,481880.5399999998,381880.5399999998
2022-07-23 08:45:00,22601.5,2022-07-23 19:45:00,22268.8,332.7,482213.2399999998,382213.2399999998
2022-07-23 20:00:00,22311.7,2022-07-24 02:45:00,22460.6,148.9,482362.13999999984,382362.13999999984
2022-07-24 03:00:00,22394.6,2022-07-24 04:45:00,22385.3,9.3,482371.4399999998,382371.4399999998
2022-07-24 05:00:00,22559.7,2022-07-24 10:15:00,22646.2,86.5,482457.9399999998,382457.9399999998
2022-07-24 10:30:00,22492.3,2022-07-24 11:15:00,22734.4,-316.0,482141.9399999998,382141.9399999998
2022-07-24 15:00:00,22847.5,2022-07-24 23:30:00,22652.8,-194.7,481947.2399999998,381947.2399999998
2022-07-24 23:45:00,22570.6,2022-07-25 08:30:00,22007.5,563.1,482510.3399999998,382510.3399999998
2022-07-25 08:45:00,22038.3,2022-07-25 14:15:00,21760.0,-342.05,482168.2899999998,382168.2899999998
2022-07-25 19:00:00,21649.4,2022-07-25 19:45:00,21879.5,-230.1,481938.1899999998,381938.1899999998
2022-07-25 20:00:00,22153.7,2022-07-25 22:00:00,21859.2,-294.5,481643.6899999998,381643.6899999998
2022-07-25 22:15:00,21617.5,2022-07-26 05:30:00,21135.1,482.4,482126.08999999985,382126.08999999985
2022-07-26 05:45:00,21137.2,2022-07-26 12:45:00,21022.9,-114.3,482011.78999999986,382011.78999999986
2022-07-26 13:00:00,20890.7,2022-07-26 16:45:00,20925.4,-34.7,481977.08999999985,381977.08999999985
2022-07-26 17:00:00,20994.5,2022-07-27 03:15:00,21099.3,104.8,482081.88999999984,382081.88999999984
2022-07-27 03:30:00,21038.9,2022-07-27 05:30:00,21221.3,-182.4,481899.4899999998,381899.4899999998
2022-07-27 05:45:00,21234.2,2022-07-27 11:30:00,21301.4,67.2,481966.6899999998,381966.6899999998
2022-07-27 11:45:00,21193.2,2022-07-27 12:15:00,21261.0,-67.8,481898.88999999984,381898.88999999984
2022-07-27 12:30:00,21373.9,2022-07-27 22:15:00,22804.27,1430.37,483329.25999999983,383329.25999999983
2022-07-28 02:00:00,22738.1,2022-07-28 02:30:00,22933.8,-195.7,483133.5599999998,383133.5599999998
2022-07-28 02:45:00,23276.7,2022-07-28 04:15:00,23164.2,-112.5,483021.0599999998,383021.0599999998
2022-07-28 04:30:00,23112.8,2022-07-28 11:30:00,23084.1,28.7,483049.75999999983,383049.75999999983
2022-07-28 11:45:00,23106.0,2022-07-28 12:30:00,22918.3,-385.31,482664.44999999984,382664.44999999984
2022-07-29 00:15:00,23707.0,2022-07-29 04:30:00,23949.5,-313.83,482350.6199999998,382350.6199999998
2022-07-29 05:30:00,24036.7,2022-07-29 06:30:00,24238.9,202.2,482552.81999999983,382552.81999999983
2022-07-29 06:45:00,23936.3,2022-07-29 13:45:00,23694.0,242.3,482795.1199999998,382795.1199999998
2022-07-29 14:00:00,24020.1,2022-07-29 15:45:00,24003.0,-17.1,482778.01999999984,382778.01999999984
2022-07-29 16:00:00,23662.0,2022-07-29 22:45:00,23938.0,-276.0,482502.01999999984,382502.01999999984
2022-07-29 23:00:00,24093.4,2022-07-30 01:45:00,23909.1,-425.08,482076.9399999998,382076.9399999998
2022-07-30 03:30:00,23761.2,2022-07-30 07:00:00,23845.9,-84.7,481992.2399999998,381992.2399999998
2022-07-30 07:15:00,23872.9,2022-07-30 19:15:00,24422.0,549.1,482541.3399999998,382541.3399999998
2022-07-30 19:30:00,24086.5,2022-07-30 19:30:00,24086.5,-343.68,482197.6599999998,382197.6599999998
2022-07-31 04:15:00,23803.4,2022-07-31 08:30:00,23655.1,-148.3,482049.3599999998,382049.3599999998
2022-07-31 08:45:00,23588.5,2022-07-31 10:30:00,23762.6,-174.1,481875.25999999983,381875.25999999983
2022-07-31 10:45:00,23816.2,2022-07-31 18:00:00,24117.0,300.8,482176.0599999998,382176.0599999998
2022-07-31 18:15:00,23658.5,2022-07-31 18:15:00,23658.5,-395.1,481780.95999999985,381780.95999999985
2022-07-31 19:00:00,23888.0,2022-07-31 21:45:00,23582.0,-306.0,481474.95999999985,381474.95999999985
2022-07-31 22:00:00,23437.5,2022-08-01 08:45:00,23280.5,157.0,481631.95999999985,381631.95999999985
2022-08-01 09:00:00,23326.8,2022-08-01 10:15:00,23252.1,-74.7,481557.25999999983,381557.25999999983
2022-08-01 10:30:00,23036.3,2022-08-01 11:30:00,23194.9,-158.6,481398.65999999986,381398.65999999986
2022-08-01 11:45:00,23216.2,2022-08-01 17:00:00,23166.5,-49.7,481348.95999999985,381348.95999999985
2022-08-01 17:15:00,22966.0,2022-08-01 22:45:00,23152.9,-186.9,481162.0599999998,381162.0599999998
2022-08-01 23:00:00,23363.0,2022-08-02 01:15:00,23150.9,-212.1,480949.95999999985,380949.95999999985
2022-08-02 01:30:00,23014.5,2022-08-02 11:00:00,22865.0,149.5,481099.45999999985,381099.45999999985
2022-08-02 11:15:00,22885.0,2022-08-02 18:30:00,23132.8,247.8,481347.25999999983,381347.25999999983
2022-08-02 18:45:00,22973.0,2022-08-03 05:15:00,22862.1,110.9,481458.15999999986,381458.15999999986
2022-08-03 05:30:00,22926.0,2022-08-03 12:15:00,23420.8,494.8,481952.95999999985,381952.95999999985
2022-08-03 12:30:00,23344.4,2022-08-03 19:15:00,23439.9,-95.5,481857.45999999985,381857.45999999985
2022-08-03 19:30:00,23504.8,2022-08-03 21:45:00,23262.2,-242.6,481614.85999999987,381614.85999999987
2022-08-03 22:00:00,23259.8,2022-08-04 00:45:00,22990.0,269.8,481884.65999999986,381884.65999999986
2022-08-04 01:00:00,23055.1,2022-08-04 06:00:00,23120.0,64.9,481949.5599999999,381949.5599999999
2022-08-04 06:15:00,22845.3,2022-08-04 13:15:00,22923.2,-77.9,481871.65999999986,381871.65999999986
2022-08-04 13:30:00,23072.2,2022-08-04 15:15:00,22843.8,-228.4,481643.25999999983,381643.25999999983
2022-08-04 15:30:00,22799.9,2022-08-04 23:45:00,22608.9,191.0,481834.25999999983,381834.25999999983
2022-08-05 00:00:00,22631.6,2022-08-05 07:30:00,23191.7,560.1,482394.3599999998,382394.3599999998
2022-08-05 07:45:00,23176.9,2022-08-05 11:15:00,23271.8,-94.9,482299.4599999998,382299.4599999998
2022-08-05 11:30:00,23360.9,2022-08-05 12:15:00,23392.6,31.7,482331.1599999998,382331.1599999998
2022-08-05 12:30:00,23074.5,2022-08-05 12:30:00,23074.5,-312.79,482018.3699999998,382018.3699999998
2022-08-05 14:00:00,23265.8,2022-08-05 15:30:00,22998.3,-267.5,481750.8699999998,381750.8699999998
2022-08-05 15:45:00,22979.1,2022-08-05 20:45:00,22969.7,9.4,481760.26999999984,381760.26999999984
2022-08-05 21:00:00,23131.4,2022-08-06 05:00:00,23182.1,50.7,481810.96999999986,381810.96999999986
2022-08-06 05:15:00,23140.0,2022-08-06 12:45:00,23163.6,-23.6,481787.3699999999,381787.3699999999
2022-08-06 13:00:00,23212.7,2022-08-06 16:45:00,23146.5,-66.2,481721.16999999987,381721.16999999987
2022-08-06 17:00:00,23072.6,2022-08-06 17:00:00,23072.6,0.0,481721.16999999987,381721.16999999987
2022-08-06 17:15:00,23187.1,2022-08-06 23:00:00,23147.4,-39.7,481681.46999999986,381681.46999999986
2022-08-06 23:15:00,22990.1,2022-08-07 03:45:00,22979.7,10.4,481691.8699999999,381691.8699999999
2022-08-07 04:00:00,22987.6,2022-08-07 08:45:00,22912.8,-74.8,481617.0699999999,381617.0699999999
2022-08-07 09:00:00,22892.3,2022-08-07 11:30:00,22969.5,-77.2,481539.8699999999,381539.8699999999
2022-08-07 11:45:00,23026.1,2022-08-07 15:30:00,23059.3,33.2,481573.0699999999,381573.0699999999
2022-08-07 15:45:00,23012.1,2022-08-07 16:45:00,23080.0,-67.9,481505.16999999987,381505.16999999987
2022-08-07 17:00:00,23224.1,2022-08-07 19:30:00,23181.4,-42.7,481462.46999999986,381462.46999999986
2022-08-07 19:45:00,23154.9,2022-08-07 20:45:00,23254.0,-99.1,481363.3699999999,381363.3699999999
2022-08-07 21:00:00,23357.2,2022-08-07 22:15:00,23253.2,-104.0,481259.3699999999,381259.3699999999
2022-08-07 22:30:00,23212.0,2022-08-07 23:45:00,23167.8,44.2,481303.5699999999,381303.5699999999
2022-08-08 00:00:00,23280.0,2022-08-08 10:45:00,24097.19,817.19,482120.7599999999,382120.7599999999
2022-08-08 16:15:00,23866.3,2022-08-08 20:30:00,23945.8,-79.5,482041.2599999999,382041.2599999999
2022-08-08 20:45:00,24050.1,2022-08-08 21:15:00,23837.7,-284.29,481756.9699999999,381756.9699999999
2022-08-08 22:00:00,23783.1,2022-08-09 04:15:00,23809.1,-26.0,481730.9699999999,381730.9699999999
2022-08-09 04:30:00,23845.6,2022-08-09 09:00:00,23802.8,-42.8,481688.1699999999,381688.1699999999
2022-08-09 09:15:00,23695.9,2022-08-09 20:00:00,23051.1,644.8,482332.9699999999,382332.9699999999
2022-08-09 20:15:00,23104.4,2022-08-10 00:00:00,23078.1,-26.3,482306.6699999999,382306.6699999999
2022-08-10 00:15:00,23031.3,2022-08-10 01:00:00,22851.8,179.5,482486.1699999999,382486.1699999999
2022-08-10 01:15:00,22909.5,2022-08-10 17:45:00,23923.67,1014.17,483500.3399999999,383500.3399999999
2022-08-10 18:15:00,23749.0,2022-08-10 20:30:00,23716.4,32.6,483532.9399999999,383532.9399999999
2022-08-10 20:45:00,23883.2,2022-08-10 22:30:00,23862.3,-20.9,483512.03999999986,383512.03999999986
2022-08-10 22:45:00,23833.8,2022-08-11 00:45:00,24041.5,-207.7,483304.33999999985,383304.33999999985
2022-08-11 01:00:00,24160.9,2022-08-11 09:30:00,24483.0,322.1,483626.4399999998,383626.4399999998
2022-08-11 09:45:00,24427.2,2022-08-11 12:30:00,24673.6,-383.96,483242.4799999998,383242.4799999998
2022-08-11 12:45:00,24851.6,2022-08-11 15:15:00,24478.4,-465.68,482776.7999999998,382776.7999999998
2022-08-11 15:30:00,24389.4,2022-08-12 09:00:00,23938.1,451.3,483228.0999999998,383228.0999999998
2022-08-12 09:15:00,24020.7,2022-08-12 10:00:00,23904.8,-115.9,483112.1999999998,383112.1999999998
2022-08-12 10:15:00,23850.4,2022-08-12 13:15:00,23789.1,61.3,483173.49999999977,383173.49999999977
2022-08-12 13:30:00,23836.3,2022-08-13 02:45:00,24683.86,847.56,484021.05999999976,384021.05999999976
2022-08-13 07:45:00,24566.1,2022-08-13 17:00:00,24486.3,79.8,484100.85999999975,384100.85999999975
2022-08-13 17:15:00,24507.1,2022-08-13 23:45:00,24429.0,-78.1,484022.7599999998,384022.7599999998
2022-08-14 00:00:00,24348.5,2022-08-14 01:00:00,24552.9,-241.58,483781.17999999976,383781.17999999976
2022-08-14 03:30:00,24575.5,2022-08-14 08:15:00,24826.7,251.2,484032.3799999998,384032.3799999998
2022-08-14 08:30:00,24730.9,2022-08-14 20:45:00,24299.8,431.1,484463.47999999975,384463.47999999975
2022-08-14 21:00:00,24342.7,2022-08-15 04:00:00,24788.9,446.2,484909.67999999976,384909.67999999976
2022-08-15 04:15:00,24760.1,2022-08-15 10:30:00,24140.4,619.7,485529.3799999998,385529.3799999998
2022-08-15 10:45:00,24253.8,2022-08-15 12:30:00,24062.2,-191.6,485337.7799999998,385337.7799999998
2022-08-15 12:45:00,23937.6,2022-08-15 16:00:00,24190.4,-318.5,485019.2799999998,385019.2799999998
2022-08-15 16:15:00,24209.8,2022-08-15 19:30:00,24005.2,-204.6,484814.6799999998,384814.6799999998
2022-08-15 19:45:00,23972.2,2022-08-15 23:15:00,24040.9,-68.7,484745.9799999998,384745.9799999998
2022-08-15 23:30:00,24147.6,2022-08-16 02:45:00,24035.8,-111.8,484634.1799999998,384634.1799999998
2022-08-16 03:00:00,23859.4,2022-08-16 09:00:00,24018.7,-159.3,484474.87999999983,384474.87999999983
2022-08-16 09:15:00,24070.5,2022-08-16 13:00:00,23957.9,-112.6,484362.27999999985,384362.27999999985
2022-08-16 13:15:00,23923.1,2022-08-16 17:45:00,23849.6,73.5,484435.77999999985,384435.77999999985
2022-08-16 18:00:00,23949.1,2022-08-17 07:00:00,24352.3,403.2,484838.97999999986,384838.97999999986
2022-08-17 07:15:00,24047.6,2022-08-17 07:15:00,24047.6,-315.73,484523.2499999999,384523.2499999999
2022-08-18 00:30:00,23448.2,2022-08-18 14:00:00,23460.0,11.8,484535.0499999999,384535.0499999999
2022-08-18 14:15:00,23379.1,2022-08-19 05:30:00,22811.88,567.22,485102.26999999984,385102.26999999984
2022-08-19 06:45:00,21898.9,2022-08-19 09:45:00,21736.5,-162.4,484939.8699999998,384939.8699999998
2022-08-19 10:00:00,21677.5,2022-08-19 21:45:00,21070.9,606.6,485546.4699999998,385546.4699999998
2022-08-19 22:00:00,21274.3,2022-08-19 23:00:00,20912.7,-422.64,485123.8299999998,385123.8299999998
2022-08-19 23:30:00,20869.7,2022-08-20 02:15:00,21113.2,-243.5,484880.3299999998,384880.3299999998
2022-08-20 02:30:00,21130.1,2022-08-20 10:15:00,21160.9,30.8,484911.1299999998,384911.1299999998
2022-08-20 10:30:00,21145.6,2022-08-20 13:30:00,21246.9,-101.3,484809.8299999998,384809.8299999998
2022-08-20 13:45:00,21308.3,2022-08-20 18:30:00,21230.7,-77.6,484732.2299999998,384732.2299999998
2022-08-20 18:45:00,21095.1,2022-08-20 21:30:00,21021.8,73.3,484805.5299999998,384805.5299999998
2022-08-20 21:45:00,21106.5,2022-08-21 06:15:00,21184.7,78.2,484883.7299999998,384883.7299999998
2022-08-21 06:30:00,21115.4,2022-08-21 07:45:00,21241.7,-126.3,484757.4299999998,384757.4299999998
2022-08-21 08:00:00,21402.4,2022-08-21 15:00:00,21394.2,-8.2,484749.2299999998,384749.2299999998
2022-08-21 15:15:00,21370.1,2022-08-21 19:15:00,21514.1,-144.0,484605.2299999998,384605.2299999998
2022-08-21 19:30:00,21524.4,2022-08-21 21:15:00,21632.2,107.8,484713.0299999998,384713.0299999998
2022-08-21 21:30:00,21480.2,2022-08-22 10:00:00,21149.8,330.4,485043.4299999998,385043.4299999998
2022-08-22 10:15:00,21251.9,2022-08-22 17:15:00,21260.1,8.2,485051.62999999983,385051.62999999983
2022-08-22 17:30:00,21230.5,2022-08-22 22:15:00,21170.0,60.5,485112.12999999983,385112.12999999983
2022-08-22 22:30:00,21212.8,2022-08-23 03:30:00,21278.6,65.8,485177.9299999998,385177.9299999998
2022-08-23 03:45:00,21228.5,2022-08-23 07:00:00,21138.5,90.0,485267.9299999998,385267.9299999998
2022-08-23 07:15:00,21160.0,2022-08-24 00:15:00,21444.9,284.9,485552.82999999984,385552.82999999984
2022-08-24 00:30:00,21344.4,2022-08-24 05:00:00,21323.6,20.8,485573.62999999983,385573.62999999983
2022-08-24 05:15:00,21428.1,2022-08-24 10:30:00,21321.2,-106.9,485466.7299999998,385466.7299999998
2022-08-24 10:45:00,21274.9,2022-08-24 12:00:00,21450.3,-175.4,485291.3299999998,385291.3299999998
2022-08-24 12:15:00,21459.7,2022-08-24 17:00:00,21737.9,278.2,485569.5299999998,385569.5299999998
2022-08-24 17:15:00,21633.2,2022-08-25 01:00:00,21476.1,157.1,485726.6299999998,385726.6299999998
2022-08-25 01:15:00,21526.3,2022-08-25 10:30:00,21692.0,165.7,485892.3299999998,385892.3299999998
2022-08-25 10:45:00,21612.5,2022-08-25 19:00:00,21549.2,63.3,485955.6299999998,385955.6299999998
2022-08-25 19:15:00,21600.0,2022-08-26 04:00:00,21540.0,-60.0,485895.6299999998,385895.6299999998
2022-08-26 04:15:00,21504.0,2022-08-26 12:00:00,21194.9,309.1,486204.72999999975,386204.72999999975
2022-08-26 12:15:00,21280.8,2022-08-26 14:15:00,21442.0,161.2,486365.92999999976,386365.92999999976
2022-08-26 14:30:00,21276.8,2022-08-26 23:00:00,20270.03,1006.77,487372.6999999998,387372.6999999998
2022-08-27 07:15:00,20184.4,2022-08-27 14:30:00,20135.4,-49.0,487323.6999999998,387323.6999999998
2022-08-27 14:45:00,20054.2,2022-08-27 17:15:00,19983.9,70.3,487393.99999999977,387393.99999999977
2022-08-27 17:30:00,20054.3,2022-08-27 21:30:00,19973.6,-80.7,487313.29999999976,387313.29999999976
2022-08-27 21:45:00,19862.0,2022-08-28 01:15:00,20036.3,-208.28,487105.0199999997,387105.0199999997
2022-08-28 01:30:00,20050.8,2022-08-28 04:00:00,19976.6,-74.2,487030.8199999997,387030.8199999997
2022-08-28 04:15:00,19953.4,2022-08-28 15:15:00,19963.3,-9.9,487020.9199999997,387020.9199999997
2022-08-28 15:30:00,19991.8,2022-08-28 19:15:00,20005.4,13.6,487034.51999999967,387034.51999999967
2022-08-28 19:30:00,19955.1,2022-08-29 02:00:00,19691.2,263.9,487298.4199999997,387298.4199999997
2022-08-29 02:15:00,19761.2,2022-08-29 05:30:00,19774.4,13.2,487311.6199999997,387311.6199999997
2022-08-29 05:45:00,19745.3,2022-08-29 12:00:00,19814.9,-69.6,487242.0199999997,387242.0199999997
2022-08-29 12:15:00,19971.9,2022-08-29 18:00:00,20193.0,221.1,487463.1199999997,387463.1199999997
2022-08-29 18:15:00,20155.3,2022-08-29 23:15:00,20224.7,-69.4,487393.7199999997,387393.7199999997
2022-08-29 23:30:00,20301.3,2022-08-30 01:15:00,20235.6,-65.7,487328.01999999967,387328.01999999967
2022-08-30 01:30:00,20120.6,2022-08-30 03:45:00,20261.3,-140.7,487187.31999999966,387187.31999999966
2022-08-30 04:00:00,20287.6,2022-08-30 10:45:00,20384.4,96.8,487284.11999999965,387284.11999999965
2022-08-30 11:00:00,20365.9,2022-08-30 18:45:00,19765.9,600.0,487884.11999999965,387884.11999999965
2022-08-30 19:00:00,20011.4,2022-08-31 06:15:00,20275.7,264.3,488148.41999999963,388148.41999999963
2022-08-31 06:30:00,20212.0,2022-08-31 19:15:00,20139.3,72.7,488221.11999999965,388221.11999999965
2022-08-31 19:30:00,20231.5,2022-08-31 22:45:00,20148.2,-83.3,488137.81999999966,388137.81999999966
2022-08-31 23:00:00,20043.0,2022-09-01 02:00:00,20167.7,-124.7,488013.11999999965,388013.11999999965
2022-09-01 02:15:00,20178.8,2022-09-01 06:30:00,19989.9,-188.9,487824.2199999996,387824.2199999996
2022-09-01 06:45:00,19975.8,2022-09-01 10:30:00,19987.7,-11.9,487812.3199999996,387812.3199999996
2022-09-01 10:45:00,20010.9,2022-09-01 14:30:00,19864.2,-146.7,487665.6199999996,387665.6199999996
2022-09-01 14:45:00,19685.3,2022-09-01 19:30:00,19813.8,-128.5,487537.1199999996,387537.1199999996
2022-09-01 19:45:00,19857.4,2022-09-02 02:00:00,19996.3,138.9,487676.0199999996,387676.0199999996
2022-09-02 02:15:00,19953.1,2022-09-02 03:00:00,20165.9,-227.48,487448.53999999963,387448.53999999963
2022-09-02 03:30:00,20194.7,2022-09-02 05:15:00,20100.0,-94.7,487353.8399999996,387353.8399999996
2022-09-02 05:30:00,20075.9,2022-09-02 12:15:00,20106.8,-30.9,487322.9399999996,387322.9399999996
2022-09-02 12:30:00,20257.6,2022-09-02 16:15:00,20247.3,-10.3,487312.6399999996,387312.6399999996
2022-09-02 16:30:00,20155.6,2022-09-03 00:00:00,19950.2,205.4,487518.03999999963,387518.03999999963
2022-09-03 00:15:00,19955.9,2022-09-03 03:00:00,19890.1,-65.8,487452.23999999964,387452.23999999964
2022-09-03 03:15:00,19869.9,2022-09-03 13:15:00,19821.7,48.2,487500.43999999965,387500.43999999965
2022-09-03 13:30:00,19846.4,2022-09-03 16:45:00,19780.6,-65.8,487434.63999999966,387434.63999999966
2022-09-03 17:00:00,19759.0,2022-09-03 21:45:00,19739.7,19.3,487453.93999999965,387453.93999999965
2022-09-03 22:00:00,19798.0,2022-09-04 06:00:00,19776.5,-21.5,487432.43999999965,387432.43999999965
2022-09-04 06:15:00,19727.0,2022-09-04 08:15:00,19647.4,79.6,487512.03999999963,387512.03999999963
2022-09-04 08:30:00,19727.0,2022-09-04 13:30:00,19773.3,46.3,487558.3399999996,387558.3399999996
2022-09-04 13:45:00,19702.4,2022-09-04 16:15:00,19748.0,-45.6,487512.73999999964,387512.73999999964
2022-09-04 16:30:00,19832.6,2022-09-05 01:15:00,19898.1,65.5,487578.23999999964,387578.23999999964
2022-09-05 01:30:00,19853.5,2022-09-05 13:45:00,19731.0,122.5,487700.73999999964,387700.73999999964
2022-09-05 14:00:00,19775.6,2022-09-05 17:45:00,19816.9,41.3,487742.03999999963,387742.03999999963
2022-09-05 18:00:00,19735.0,2022-09-05 23:45:00,19784.9,-49.9,487692.1399999996,387692.1399999996
2022-09-06 00:00:00,19857.5,2022-09-06 01:15:00,20027.3,169.8,487861.9399999996,387861.9399999996
2022-09-06 01:30:00,19872.2,2022-09-06 06:45:00,19848.2,24.0,487885.9399999996,387885.9399999996
2022-09-06 07:00:00,19876.2,2022-09-06 13:15:00,19845.6,-30.6,487855.3399999996,387855.3399999996
2022-09-06 13:30:00,19812.1,2022-09-06 21:00:00,18973.8,838.3,488693.6399999996,388693.6399999996
2022-09-06 21:15:00,18974.0,2022-09-06 23:30:00,18847.5,-126.5,488567.1399999996,388567.1399999996
2022-09-06 23:45:00,18781.5,2022-09-07 04:45:00,18714.9,66.6,488633.7399999996,388633.7399999996
2022-09-07 05:00:00,18744.7,2022-09-08 01:15:00,19287.5,542.8,489176.5399999996,389176.5399999996
2022-09-08 01:30:00,19168.6,2022-09-08 04:30:00,19327.0,-190.21,488986.32999999955,388986.32999999955
2022-09-08 04:45:00,19342.3,2022-09-08 07:00:00,19223.0,-119.3,488867.02999999956,388867.02999999956
2022-09-08 07:15:00,19103.5,2022-09-08 09:45:00,19177.6,-74.1,488792.9299999996,388792.9299999996
2022-09-08 10:00:00,19252.8,2022-09-08 12:15:00,19247.4,-5.4,488787.52999999956,388787.52999999956
2022-09-08 12:30:00,19118.6,2022-09-08 13:15:00,19112.6,6.0,488793.52999999956,388793.52999999956
2022-09-08 13:30:00,19341.3,2022-09-09 05:30:00,20684.87,1343.57,490137.09999999957,390137.09999999957
2022-09-10 00:00:00,21253.6,2022-09-10 04:30:00,21376.5,-122.9,490014.19999999955,390014.19999999955
2022-09-10 04:45:00,21447.4,2022-09-10 07:15:00,21477.9,30.5,490044.69999999955,390044.69999999955
2022-09-10 07:30:00,21364.0,2022-09-10 16:30:00,21331.1,32.9,490077.59999999957,390077.59999999957
2022-09-10 16:45:00,21401.1,2022-09-11 00:30:00,21561.0,159.9,490237.4999999996,390237.4999999996
2022-09-11 00:45:00,21540.4,2022-09-11 07:15:00,21556.9,-16.5,490220.9999999996,390220.9999999996
2022-09-11 07:30:00,21605.0,2022-09-11 14:00:00,21555.0,-50.0,490170.9999999996,390170.9999999996
2022-09-11 14:15:00,21476.7,2022-09-11 15:15:00,21602.0,-125.3,490045.6999999996,390045.6999999996
2022-09-11 15:30:00,21682.0,2022-09-11 17:30:00,21672.8,-9.2,490036.4999999996,390036.4999999996
2022-09-11 17:45:00,21621.4,2022-09-11 23:15:00,21640.8,-19.4,490017.09999999957,390017.09999999957
2022-09-11 23:30:00,21732.0,2022-09-12 01:45:00,22036.5,304.5,490321.59999999957,390321.59999999957
2022-09-12 02:00:00,21812.6,2022-09-12 06:45:00,21810.1,2.5,490324.09999999957,390324.09999999957
2022-09-12 07:00:00,21902.7,2022-09-12 15:45:00,22106.0,203.3,490527.39999999956,390527.39999999956
2022-09-12 16:00:00,22086.4,2022-09-12 18:30:00,22312.2,-225.8,490301.59999999957,390301.59999999957
2022-09-12 18:45:00,22390.3,2022-09-13 00:00:00,22387.9,-2.4,490299.19999999955,390299.19999999955
2022-09-13 00:15:00,22140.8,2022-09-13 04:00:00,22203.2,-62.4,490236.7999999995,390236.7999999995
2022-09-13 04:15:00,22339.4,2022-09-13 06:30:00,22372.9,33.5,490270.2999999995,390270.2999999995
2022-09-13 06:45:00,22309.0,2022-09-13 10:00:00,22365.4,-56.4,490213.8999999995,390213.8999999995
2022-09-13 10:15:00,22471.9,2022-09-13 12:30:00,21665.3,-603.52,489610.3799999995,389610.3799999995
2022-09-13 12:45:00,21397.2,2022-09-13 21:30:00,19932.08,1465.12,491075.4999999995,391075.4999999995
2022-09-14 01:00:00,20272.8,2022-09-14 06:15:00,20294.1,21.3,491096.79999999946,391096.79999999946
2022-09-14 06:30:00,20218.4,2022-09-14 08:30:00,20348.3,-129.9,490966.89999999944,390966.89999999944
2022-09-14 08:45:00,20373.2,2022-09-14 11:45:00,20219.8,-221.11,490745.78999999946,390745.78999999946
2022-09-14 12:00:00,20135.5,2022-09-14 12:45:00,20300.3,-164.8,490580.98999999947,390580.98999999947
2022-09-14 13:00:00,20368.4,2022-09-14 17:30:00,20180.1,-188.3,490392.6899999995,390392.6899999995
2022-09-14 17:45:00,20094.6,2022-09-14 21:15:00,19949.5,145.1,490537.78999999946,390537.78999999946
2022-09-14 21:30:00,20030.0,2022-09-15 00:45:00,20149.2,119.2,490656.98999999947,390656.98999999947
2022-09-15 01:00:00,19955.9,2022-09-15 16:30:00,19835.6,120.3,490777.28999999946,390777.28999999946
2022-09-15 16:45:00,19856.4,2022-09-15 22:45:00,19721.0,-268.26,490509.02999999945,390509.02999999945
2022-09-16 00:00:00,19658.7,2022-09-16 03:45:00,19738.4,-79.7,490429.32999999943,390429.32999999943
2022-09-16 04:00:00,19826.2,2022-09-16 08:00:00,19704.7,-121.5,490307.82999999943,390307.82999999943
2022-09-16 08:15:00,19677.9,2022-09-16 10:00:00,19735.3,-57.4,490250.4299999994,390250.4299999994
2022-09-16 10:15:00,19776.6,2022-09-16 12:30:00,19794.3,17.7,490268.1299999994,390268.1299999994
2022-09-16 12:45:00,19682.0,2022-09-16 13:45:00,19519.3,162.7,490430.82999999943,390430.82999999943
2022-09-16 14:00:00,19697.8,2022-09-16 17:00:00,19448.8,-344.26,490086.5699999994,390086.5699999994
2022-09-16 17:15:00,19361.0,2022-09-16 19:15:00,19573.1,-212.1,489874.46999999945,389874.46999999945
2022-09-16 19:30:00,19629.3,2022-09-17 03:30:00,19884.8,255.5,490129.96999999945,390129.96999999945
2022-09-17 03:45:00,19875.0,2022-09-17 13:00:00,19846.0,29.0,490158.96999999945,390158.96999999945
2022-09-17 13:15:00,19862.1,2022-09-17 19:15:00,20007.8,145.7,490304.66999999946,390304.66999999946
2022-09-17 19:30:00,19991.8,2022-09-17 22:30:00,20101.5,-109.7,490194.96999999945,390194.96999999945
2022-09-17 22:45:00,20116.4,2022-09-18 03:45:00,19990.9,-155.42,490039.54999999946,390039.54999999946
2022-09-18 04:00:00,19965.1,2022-09-18 05:45:00,20059.6,-94.5,489945.04999999946,389945.04999999946
2022-09-18 06:00:00,20069.7,2022-09-18 09:30:00,19991.1,-78.6,489866.4499999995,389866.4499999995
2022-09-18 09:45:00,19824.5,2022-09-18 09:45:00,19824.5,-154.92,489711.5299999995,389711.5299999995
2022-09-18 10:15:00,19979.1,2022-09-18 14:15:00,19897.4,-81.7,489629.8299999995,389629.8299999995
2022-09-18 14:30:00,19830.2,2022-09-19 02:15:00,18788.16,1042.04,490671.8699999995,390671.8699999995
2022-09-19 10:15:00,18542.2,2022-09-19 17:15:00,19073.3,531.1,491202.96999999945,391202.96999999945
2022-09-19 17:30:00,18955.2,2022-09-19 18:45:00,19147.9,-192.7,491010.26999999944,391010.26999999944
2022-09-19 19:00:00,19360.3,2022-09-20 03:00:00,19446.6,86.3,491096.5699999994,391096.5699999994
2022-09-20 03:15:00,19199.7,2022-09-20 06:45:00,19373.0,-173.3,490923.26999999944,390923.26999999944
2022-09-20 07:00:00,19496.0,2022-09-20 08:45:00,19295.0,-201.0,490722.26999999944,390722.26999999944
2022-09-20 09:00:00,19286.8,2022-09-20 14:45:00,19061.3,225.5,490947.76999999944,390947.76999999944
2022-09-20 15:00:00,19112.8,2022-09-20 17:15:00,18941.5,-171.3,490776.46999999945,390776.46999999945
2022-09-20 17:30:00,18852.9,2022-09-20 21:00:00,18956.4,-103.5,490672.96999999945,390672.96999999945
2022-09-20 21:15:00,19035.0,2022-09-21 05:45:00,18914.8,-120.2,490552.76999999944,390552.76999999944
2022-09-21 06:00:00,18893.5,2022-09-21 09:45:00,18988.8,-95.3,490457.46999999945,390457.46999999945
2022-09-21 10:00:00,18995.5,2022-09-21 14:45:00,19245.5,250.0,490707.46999999945,390707.46999999945
2022-09-21 15:00:00,19160.0,2022-09-21 17:15:00,19289.3,-129.3,490578.16999999946,390578.16999999946
2022-09-21 17:30:00,19485.5,2022-09-21 18:00:00,18859.8,-785.13,489793.03999999946,389793.03999999946
2022-09-21 18:15:00,19048.5,2022-09-22 02:15:00,18499.6,548.9,490341.9399999995,390341.9399999995
2022-09-22 02:30:00,18589.9,2022-09-22 13:30:00,18984.6,394.7,490736.6399999995,390736.6399999995
2022-09-22 13:45:00,18893.2,2022-09-22 18:30:00,19100.0,-206.8,490529.8399999995,390529.8399999995
2022-09-22 18:45:00,19185.6,2022-09-22 21:15:00,19179.4,-6.2,490523.6399999995,390523.6399999995
2022-09-22 21:30:00,19157.9,2022-09-22 22:45:00,19387.0,-229.1,490294.5399999995,390294.5399999995
2022-09-22 23:00:00,19467.5,2022-09-23 06:45:00,19323.5,-144.0,490150.5399999995,390150.5399999995
2022-09-23 07:00:00,19266.6,2022-09-23 19:45:00,18798.7,467.9,490618.43999999954,390618.43999999954
2022-09-23 20:00:00,18867.7,2022-09-24 01:45:00,19110.1,242.4,490860.83999999956,390860.83999999956
2022-09-24 02:00:00,19096.0,2022-09-24 12:15:00,19062.3,33.7,490894.5399999996,390894.5399999996
2022-09-24 12:30:00,19169.6,2022-09-24 21:00:00,19094.0,-75.6,490818.9399999996,390818.9399999996
2022-09-24 21:15:00,18962.4,2022-09-25 01:15:00,18944.9,17.5,490836.4399999996,390836.4399999996
2022-09-25 01:30:00,18974.0,2022-09-25 12:45:00,19079.8,105.8,490942.2399999996,390942.2399999996
2022-09-25 13:00:00,19053.4,2022-09-25 15:45:00,18978.3,75.1,491017.33999999956,391017.33999999956
2022-09-25 16:00:00,19057.4,2022-09-25 17:15:00,18912.6,-144.8,490872.5399999996,390872.5399999996
2022-09-25 17:30:00,18904.0,2022-09-26 02:15:00,18888.7,15.3,490887.83999999956,390887.83999999956
2022-09-26 02:30:00,18878.4,2022-09-26 05:45:00,18760.2,-118.2,490769.63999999955,390769.63999999955
2022-09-26 06:00:00,18693.3,2022-09-26 07:15:00,18850.8,-157.5,490612.13999999955,390612.13999999955
2022-09-26 07:30:00,18909.8,2022-09-26 10:45:00,19084.0,174.2,490786.33999999956,390786.33999999956
2022-09-26 11:00:00,18964.9,2022-09-26 13:15:00,19049.1,-84.2,490702.13999999955,390702.13999999955
2022-09-26 13:30:00,19132.9,2022-09-27 05:45:00,20198.21,1065.31,491767.44999999955,391767.44999999955
2022-09-27 15:45:00,19885.3,2022-09-27 22:45:00,19066.6,818.7,492586.14999999956,392586.14999999956
2022-09-27 23:00:00,19146.2,2022-09-28 01:45:00,18997.9,-148.3,492437.84999999957,392437.84999999957
2022-09-28 02:00:00,18831.6,2022-09-28 04:15:00,18782.3,49.3,492487.14999999956,392487.14999999956
2022-09-28 04:30:00,18788.4,2022-09-28 23:15:00,19529.8,741.4,493228.5499999996,393228.5499999996
2022-09-28 23:30:00,19436.5,2022-09-29 04:00:00,19509.5,-73.0,493155.5499999996,393155.5499999996
2022-09-29 04:15:00,19536.0,2022-09-29 05:45:00,19446.6,-89.4,493066.14999999956,393066.14999999956
2022-09-29 06:00:00,19348.3,2022-09-29 11:15:00,19478.4,-130.1,492936.0499999996,392936.0499999996
2022-09-29 11:30:00,19502.6,2022-09-29 12:15:00,19374.9,-127.7,492808.34999999957,392808.34999999957
2022-09-29 12:30:00,19215.6,2022-09-29 15:00:00,19210.6,5.0,492813.34999999957,392813.34999999957
2022-09-29 15:15:00,19265.1,2022-09-30 02:00:00,19428.3,163.2,492976.5499999996,392976.5499999996
2022-09-30 02:15:00,19377.7,2022-09-30 06:45:00,19438.6,-60.9,492915.64999999956,392915.64999999956
2022-09-30 07:00:00,19543.9,2022-09-30 11:30:00,19470.5,-73.4,492842.24999999953,392842.24999999953
2022-09-30 11:45:00,19430.3,2022-09-30 13:30:00,19337.6,92.7,492934.94999999955,392934.94999999955
2022-09-30 13:45:00,19465.3,2022-09-30 15:45:00,19749.4,284.1,493219.0499999995,393219.0499999995
2022-09-30 16:00:00,19664.6,2022-10-01 03:30:00,19393.3,271.3,493490.3499999995,393490.3499999995
2022-10-01 03:45:00,19408.0,2022-10-01 07:00:00,19294.9,-144.13,493346.2199999995,393346.2199999995
2022-10-01 11:15:00,19199.4,2022-10-01 11:30:00,19284.6,-85.2,493261.0199999995,393261.0199999995
2022-10-01 11:45:00,19304.2,2022-10-01 17:45:00,19266.8,-37.4,493223.6199999995,393223.6199999995
2022-10-01 18:00:00,19240.0,2022-10-01 22:15:00,19307.1,-67.1,493156.5199999995,393156.5199999995
2022-10-01 22:30:00,19312.9,2022-10-02 08:15:00,19276.9,-36.0,493120.5199999995,393120.5199999995
2022-10-02 08:30:00,19256.9,2022-10-02 11:00:00,19150.1,106.8,493227.3199999995,393227.3199999995
2022-10-02 11:15:00,19252.5,2022-10-02 14:30:00,19129.1,-123.4,493103.91999999946,393103.91999999946
2022-10-02 14:45:00,19096.0,2022-10-02 17:15:00,19180.0,-84.0,493019.91999999946,393019.91999999946
2022-10-02 17:30:00,19203.3,2022-10-02 20:45:00,19223.3,20.0,493039.91999999946,393039.91999999946
2022-10-02 21:00:00,19174.0,2022-10-03 00:45:00,19084.0,90.0,493129.91999999946,393129.91999999946
2022-10-03 01:00:00,19181.4,2022-10-03 09:15:00,19172.9,-8.5,493121.41999999946,393121.41999999946
2022-10-03 09:30:00,19148.3,2022-10-03 12:45:00,19245.9,-97.6,493023.8199999995,393023.8199999995
2022-10-03 13:00:00,19293.5,2022-10-04 01:30:00,19542.0,248.5,493272.3199999995,393272.3199999995
2022-10-04 01:45:00,19500.1,2022-10-04 05:15:00,19609.2,-152.22,493120.0999999995,393120.0999999995
2022-10-04 06:15:00,19713.3,2022-10-04 08:30:00,19940.8,227.5,493347.5999999995,393347.5999999995
2022-10-04 08:45:00,19879.7,2022-10-04 13:30:00,20044.6,-240.69,493106.9099999995,393106.9099999995
2022-10-04 13:45:00,20089.9,2022-10-04 15:45:00,20092.2,2.3,493109.2099999995,393109.2099999995
2022-10-04 16:00:00,19993.0,2022-10-04 18:30:00,20060.1,-67.1,493042.1099999995,393042.1099999995
2022-10-04 18:45:00,20115.5,2022-10-04 23:45:00,20333.0,217.5,493259.6099999995,393259.6099999995
2022-10-05 00:00:00,20242.7,2022-10-05 06:30:00,20201.0,41.7,493301.30999999953,393301.30999999953
2022-10-05 06:45:00,20244.5,2022-10-05 08:00:00,20106.8,-137.7,493163.6099999995,393163.6099999995
2022-10-05 08:15:00,20075.4,2022-10-05 15:15:00,19926.5,148.9,493312.50999999954,393312.50999999954
2022-10-05 15:30:00,19980.0,2022-10-05 20:30:00,20094.3,114.3,493426.80999999953,393426.80999999953
2022-10-05 20:45:00,19977.5,2022-10-05 23:45:00,20150.0,-172.5,493254.30999999953,393254.30999999953
2022-10-06 00:00:00,20238.1,2022-10-06 06:00:00,20250.3,12.2,493266.50999999954,393266.50999999954
2022-10-06 06:15:00,20206.0,2022-10-07 02:00:00,19976.5,229.5,493496.00999999954,393496.00999999954
2022-10-07 02:15:00,20021.1,2022-10-07 06:00:00,19950.8,-70.3,493425.70999999956,393425.70999999956
2022-10-07 06:15:00,19820.0,2022-10-07 07:45:00,19916.8,-96.8,493328.90999999957,393328.90999999957
2022-10-07 08:00:00,19953.9,2022-10-07 12:15:00,20023.2,-186.58,493142.32999999955,393142.32999999955
2022-10-07 12:45:00,19608.8,2022-10-07 20:00:00,19449.3,159.5,493301.82999999955,393301.82999999955
2022-10-07 20:15:00,19539.0,2022-10-08 03:00:00,19522.2,-16.8,493285.02999999956,393285.02999999956
2022-10-08 03:15:00,19519.1,2022-10-08 11:00:00,19497.6,21.5,493306.52999999956,393306.52999999956
2022-10-08 11:15:00,19516.5,2022-10-08 14:00:00,19464.4,-52.1,493254.4299999996,393254.4299999996
2022-10-08 14:15:00,19435.2,2022-10-08 16:15:00,19491.2,-56.0,493198.4299999996,393198.4299999996
2022-10-08 16:30:00,19501.0,2022-10-08 19:15:00,19454.3,-46.7,493151.7299999996,393151.7299999996
2022-10-08 19:30:00,19441.9,2022-10-08 22:00:00,19283.6,158.3,493310.02999999956,393310.02999999956
2022-10-08 22:15:00,19347.1,2022-10-09 04:00:00,19341.5,-5.6,493304.4299999996,393304.4299999996
2022-10-09 04:15:00,19331.7,2022-10-09 05:45:00,19398.8,-67.1,493237.3299999996,393237.3299999996
2022-10-09 06:00:00,19417.0,2022-10-09 21:45:00,19471.0,54.0,493291.3299999996,393291.3299999996
2022-10-09 22:00:00,19426.6,2022-10-10 01:00:00,19485.9,-59.3,493232.0299999996,393232.0299999996
2022-10-10 01:15:00,19493.1,2022-10-10 05:15:00,19457.0,-36.1,493195.92999999964,393195.92999999964
2022-10-10 05:30:00,19397.0,2022-10-10 09:15:00,19265.3,131.7,493327.62999999966,393327.62999999966
2022-10-10 09:30:00,19281.5,2022-10-10 15:15:00,19277.9,-3.6,493324.0299999997,393324.0299999997
2022-10-10 15:30:00,19242.1,2022-10-11 06:15:00,19046.2,195.9,493519.9299999997,393519.9299999997
2022-10-11 06:30:00,19083.8,2022-10-11 13:15:00,19112.6,28.8,493548.7299999997,393548.7299999997
2022-10-11 13:30:00,19095.6,2022-10-11 14:45:00,19028.0,67.6,493616.32999999967,393616.32999999967
2022-10-11 15:00:00,19093.9,2022-10-11 18:30:00,19025.8,-68.1,493548.2299999997,393548.2299999997
2022-10-11 18:45:00,18968.0,2022-10-11 23:30:00,19039.0,-71.0,493477.2299999997,393477.2299999997
2022-10-11 23:45:00,19055.0,2022-10-12 23:30:00,19149.3,94.3,493571.5299999997,393571.5299999997
2022-10-12 23:45:00,19148.0,2022-10-13 10:30:00,18596.21,551.79,494123.31999999966,394123.31999999966
2022-10-13 11:30:00,18812.4,2022-10-13 12:15:00,18700.0,-112.4,494010.91999999963,394010.91999999963
2022-10-13 12:30:00,18319.5,2022-10-13 12:30:00,18319.5,-451.13,493559.78999999963,393559.78999999963
2022-10-13 13:30:00,18367.7,2022-10-13 20:00:00,19409.28,1041.58,494601.36999999965,394601.36999999965
2022-10-14 07:00:00,19763.2,2022-10-14 12:30:00,19714.9,48.3,494649.66999999963,394649.66999999963
2022-10-14 12:45:00,19792.0,2022-10-14 13:45:00,19657.5,-134.5,494515.16999999963,394515.16999999963
2022-10-14 14:00:00,19442.4,2022-10-15 02:30:00,19179.9,262.5,494777.66999999963,394777.66999999963
2022-10-15 02:45:00,19186.6,2022-10-15 08:15:00,19136.0,-50.6,494727.06999999966,394727.06999999966
2022-10-15 08:30:00,19123.0,2022-10-15 10:00:00,19109.6,13.4,494740.4699999997,394740.4699999997
2022-10-15 10:15:00,19162.9,2022-10-15 17:15:00,19116.0,-46.9,494693.56999999966,394693.56999999966
2022-10-15 17:30:00,19099.0,2022-10-15 23:00:00,19043.2,55.8,494749.36999999965,394749.36999999965
2022-10-15 23:15:00,19103.1,2022-10-16 10:00:00,19136.0,32.9,494782.26999999967,394782.26999999967
2022-10-16 10:15:00,19117.7,2022-10-16 14:45:00,19120.3,-2.6,494779.6699999997,394779.6699999997
2022-10-16 15:00:00,19146.2,2022-10-16 20:00:00,19313.5,167.3,494946.9699999997,394946.9699999997
2022-10-16 20:15:00,19278.1,2022-10-16 21:45:00,19138.5,139.6,495086.56999999966,395086.56999999966
2022-10-16 22:00:00,19317.4,2022-10-17 00:45:00,19220.0,-97.4,494989.16999999963,394989.16999999963
2022-10-17 01:00:00,19176.6,2022-10-17 05:30:00,19238.7,-62.1,494927.06999999966,394927.06999999966
2022-10-17 05:45:00,19263.7,2022-10-17 17:15:00,19499.5,235.8,495162.86999999965,395162.86999999965
2022-10-17 17:30:00,19456.3,2022-10-17 22:00:00,19573.4,-151.79,495011.07999999967,395011.07999999967
2022-10-18 00:45:00,19587.9,2022-10-18 08:30:00,19558.9,-29.0,494982.07999999967,394982.07999999967
2022-10-18 08:45:00,19526.2,2022-10-18 12:15:00,19593.3,-67.1,494914.9799999997,394914.9799999997
2022-10-18 12:30:00,19593.0,2022-10-18 14:00:00,19545.4,-47.6,494867.3799999997,394867.3799999997
2022-10-18 14:15:00,19463.5,2022-10-18 20:15:00,19279.9,183.6,495050.9799999997,395050.9799999997
2022-10-18 20:30:00,19378.8,2022-10-19 00:30:00,19266.1,-112.7,494938.2799999997,394938.2799999997
2022-10-19 00:45:00,19226.1,2022-10-19 15:30:00,19216.8,9.3,494947.57999999967,394947.57999999967
2022-10-19 15:45:00,19259.8,2022-10-19 22:00:00,19173.2,-86.6,494860.9799999997,394860.9799999997
2022-10-19 22:15:00,19176.1,2022-10-20 02:00:00,19051.0,125.1,494986.07999999967,394986.07999999967
2022-10-20 02:15:00,19053.0,2022-10-20 12:30:00,19155.2,102.2,495088.2799999997,395088.2799999997
2022-10-20 12:45:00,19126.6,2022-10-20 14:00:00,19226.7,-100.1,494988.1799999997,394988.1799999997
2022-10-20 14:15:00,19292.7,2022-10-20 15:45:00,19244.3,-48.4,494939.7799999997,394939.7799999997
2022-10-20 16:00:00,19159.6,2022-10-21 01:15:00,19023.2,136.4,495076.1799999997,395076.1799999997
2022-10-21 01:30:00,19050.1,2022-10-21 06:00:00,19062.7,12.6,495088.7799999997,395088.7799999997
2022-10-21 06:15:00,19024.6,2022-10-21 12:30:00,18804.4,220.2,495308.9799999997,395308.9799999997
2022-10-21 12:45:00,18870.1,2022-10-22 00:30:00,19161.14,291.04,495600.01999999967,395600.01999999967
2022-10-22 01:15:00,19142.1,2022-10-22 06:45:00,19136.7,5.4,495605.4199999997,395605.4199999997
2022-10-22 07:00:00,19151.9,2022-10-22 16:15:00,19182.4,30.5,495635.9199999997,395635.9199999997
2022-10-22 16:30:00,19167.6,2022-10-22 20:15:00,19165.9,1.7,495637.6199999997,395637.6199999997
2022-10-22 20:30:00,19184.3,2022-10-23 01:00:00,19173.2,-11.1,495626.5199999997,395626.5199999997
2022-10-23 01:15:00,19169.6,2022-10-23 04:00:00,19189.9,-20.3,495606.21999999974,395606.21999999974
2022-10-23 04:15:00,19210.5,2022-10-23 04:45:00,19176.3,-45.75,495560.46999999974,395560.46999999974
2022-10-23 05:45:00,19167.4,2022-10-23 09:15:00,19168.1,-0.7,495559.7699999997,395559.7699999997
2022-10-23 09:30:00,19176.5,2022-10-23 11:00:00,19142.4,-42.32,495517.4499999997,395517.4499999997
2022-10-23 11:15:00,19133.1,2022-10-23 12:30:00,19106.0,27.1,495544.5499999997,395544.5499999997
2022-10-23 12:45:00,19142.9,2022-10-24 00:30:00,19513.8,370.9,495915.4499999997,395915.4499999997
2022-10-24 00:45:00,19510.4,2022-10-24 09:30:00,19347.9,162.5,496077.9499999997,396077.9499999997
2022-10-24 09:45:00,19375.1,2022-10-24 14:00:00,19311.3,-63.8,496014.14999999973,396014.14999999973
2022-10-24 14:15:00,19220.2,2022-10-24 17:45:00,19276.4,-56.2,495957.9499999997,395957.9499999997
2022-10-24 18:00:00,19295.8,2022-10-24 23:45:00,19318.1,22.3,495980.2499999997,395980.2499999997
2022-10-25 00:00:00,19305.3,2022-10-25 03:00:00,19317.9,-12.6,495967.64999999973,395967.64999999973
2022-10-25 03:15:00,19348.0,2022-10-25 06:45:00,19319.0,-29.0,495938.64999999973,395938.64999999973
2022-10-25 07:00:00,19288.7,2022-10-25 12:30:00,19270.6,18.1,495956.7499999997,395956.7499999997
2022-10-25 12:45:00,19315.0,2022-10-25 17:00:00,20142.15,827.15,496783.89999999973,396783.89999999973
2022-10-25 22:15:00,20057.4,2022-10-26 03:00:00,20183.2,-125.8,496658.09999999974,396658.09999999974
2022-10-26 03:15:00,20274.6,2022-10-26 12:00:00,20590.2,315.6,496973.6999999997,396973.6999999997
2022-10-26 12:15:00,20524.0,2022-10-26 13:45:00,20542.9,-18.9,496954.7999999997,396954.7999999997
2022-10-26 14:00:00,20750.1,2022-10-26 18:30:00,20703.2,-46.9,496907.8999999997,396907.8999999997
2022-10-26 18:45:00,20687.0,2022-10-27 04:00:00,20739.1,-52.1,496855.7999999997,396855.7999999997
2022-10-27 04:15:00,20780.6,2022-10-27 07:15:00,20708.5,-72.1,496783.6999999997,396783.6999999997
2022-10-27 07:30:00,20677.0,2022-10-27 12:30:00,20641.0,36.0,496819.6999999997,396819.6999999997
2022-10-27 12:45:00,20713.0,2022-10-27 13:45:00,20512.2,-282.93,496536.7699999997,396536.7699999997
2022-10-27 20:00:00,20490.1,2022-10-28 09:00:00,20151.5,338.6,496875.3699999997,396875.3699999997
2022-10-28 09:15:00,20204.9,2022-10-28 12:30:00,20198.3,-230.02,496645.3499999997,396645.3499999997
2022-10-28 23:30:00,20571.1,2022-10-29 02:00:00,20633.9,-62.8,496582.5499999997,396582.5499999997
2022-10-29 02:15:00,20697.4,2022-10-29 04:00:00,20697.4,0.0,496582.5499999997,396582.5499999997
2022-10-29 04:15:00,20669.4,2022-10-29 07:30:00,20712.7,-43.3,496539.2499999997,396539.2499999997
2022-10-29 07:45:00,20765.7,2022-10-29 10:15:00,20846.4,80.7,496619.9499999997,396619.9499999997
2022-10-29 10:30:00,20845.0,2022-10-29 15:00:00,20837.1,7.9,496627.84999999974,396627.84999999974
2022-10-29 15:15:00,20900.0,2022-10-29 21:45:00,20835.0,-65.0,496562.84999999974,396562.84999999974
2022-10-29 22:00:00,20777.7,2022-10-30 05:45:00,20792.9,-15.2,496547.64999999973,396547.64999999973
2022-10-30 06:00:00,20863.2,2022-10-30 08:00:00,20868.8,5.6,496553.2499999997,396553.2499999997
2022-10-30 08:15:00,20750.1,2022-10-30 19:00:00,20658.9,91.2,496644.4499999997,396644.4499999997
2022-10-30 19:15:00,20666.0,2022-10-30 21:45:00,20679.0,13.0,496657.4499999997,396657.4499999997
2022-10-30 22:00:00,20600.0,2022-10-30 23:45:00,20615.6,-15.6,496641.84999999974,396641.84999999974
2022-10-31 00:00:00,20651.3,2022-10-31 01:15:00,20560.0,-91.3,496550.54999999976,396550.54999999976
2022-10-31 01:30:00,20466.6,2022-10-31 04:45:00,20551.6,-85.0,496465.54999999976,396465.54999999976
2022-10-31 05:00:00,20571.3,2022-10-31 13:30:00,20659.1,87.8,496553.34999999974,396553.34999999974
2022-10-31 13:45:00,20315.4,2022-10-31 13:45:00,20315.4,-273.16,496280.18999999977,396280.18999999977
2022-10-31 21:30:00,20417.9,2022-11-01 11:00:00,20548.8,130.9,496411.0899999998,396411.0899999998
2022-11-01 11:15:00,20514.3,2022-11-01 20:00:00,20447.8,66.5,496477.5899999998,396477.5899999998
2022-11-01 20:15:00,20452.9,2022-11-02 06:45:00,20465.0,12.1,496489.68999999977,396489.68999999977
2022-11-02 07:00:00,20415.8,2022-11-02 08:30:00,20433.0,-17.2,496472.48999999976,396472.48999999976
2022-11-02 08:45:00,20495.9,2022-11-02 10:00:00,20399.8,-139.89,496332.59999999974,396332.59999999974
2022-11-02 10:15:00,20368.9,2022-11-02 16:30:00,20430.5,-61.6,496270.99999999977,396270.99999999977
2022-11-02 16:45:00,20513.2,2022-11-02 17:45:00,20431.2,-162.65,496108.34999999974,396108.34999999974
2022-11-02 19:15:00,20244.8,2022-11-03 01:15:00,20228.4,16.4,496124.74999999977,396124.74999999977
2022-11-03 01:30:00,20266.4,2022-11-03 08:00:00,20318.9,52.5,496177.24999999977,396177.24999999977
2022-11-03 08:15:00,20260.3,2022-11-03 14:00:00,20219.1,41.2,496218.4499999998,396218.4499999998
2022-11-03 14:15:00,20284.6,2022-11-03 21:45:00,20248.5,-36.1,496182.3499999998,396182.3499999998
2022-11-03 22:00:00,20213.6,2022-11-04 01:30:00,20263.3,-49.7,496132.6499999998,396132.6499999998
2022-11-04 01:45:00,20276.7,2022-11-04 11:45:00,20547.0,270.3,496402.9499999998,396402.9499999998
2022-11-04 12:00:00,20487.1,2022-11-04 12:30:00,20625.6,-229.13,496173.8199999998,396173.8199999998
2022-11-04 12:45:00,20749.0,2022-11-04 15:30:00,21008.4,259.4,496433.2199999998,396433.2199999998
2022-11-04 15:45:00,20829.3,2022-11-04 19:15:00,20942.3,-113.0,496320.2199999998,396320.2199999998
2022-11-04 19:30:00,21038.5,2022-11-05 07:45:00,21374.4,335.9,496656.1199999998,396656.1199999998
2022-11-05 08:00:00,21318.2,2022-11-05 11:00:00,21364.3,-46.1,496610.01999999984,396610.01999999984
2022-11-05 11:15:00,21388.3,2022-11-05 13:00:00,21305.4,-82.9,496527.1199999998,396527.1199999998
2022-11-05 13:15:00,21242.6,2022-11-05 19:45:00,21321.5,-78.9,496448.2199999998,396448.2199999998
2022-11-05 20:00:00,21327.0,2022-11-05 23:00:00,21263.4,-63.6,496384.6199999998,396384.6199999998
2022-11-05 23:15:00,21254.5,2022-11-06 08:15:00,21174.8,79.7,496464.31999999983,396464.31999999983
2022-11-06 08:30:00,21262.1,2022-11-06 13:45:00,21210.5,-51.6,496412.71999999986,396412.71999999986
2022-11-06 14:00:00,21187.5,2022-11-06 16:45:00,21248.8,-61.3,496351.41999999987,396351.41999999987
2022-11-06 17:00:00,21268.8,2022-11-06 20:45:00,21197.4,-105.54,496245.8799999999,396245.8799999999
2022-11-06 21:30:00,21159.0,2022-11-07 01:45:00,20979.2,179.8,496425.6799999999,396425.6799999999
2022-11-07 02:00:00,21050.0,2022-11-07 03:45:00,20907.6,-142.4,496283.27999999985,396283.27999999985
2022-11-07 04:00:00,20834.1,2022-11-07 10:15:00,20759.0,75.1,496358.37999999983,396358.37999999983
2022-11-07 10:30:00,20768.7,2022-11-07 21:15:00,20777.0,8.3,496366.6799999998,396366.6799999998
2022-11-07 21:30:00,20647.4,2022-11-07 23:45:00,20578.6,68.8,496435.4799999998,396435.4799999998
2022-11-08 00:00:00,20598.0,2022-11-08 02:30:00,20634.6,36.6,496472.0799999998,396472.0799999998
2022-11-08 02:45:00,20435.4,2022-11-08 02:45:00,20435.4,-207.93,496264.1499999998,396264.1499999998
2022-11-08 06:30:00,19829.4,2022-11-08 13:30:00,19636.6,-192.8,496071.3499999998,396071.3499999998
2022-11-08 13:45:00,19547.1,2022-11-08 15:45:00,19513.8,33.3,496104.6499999998,396104.6499999998
2022-11-08 16:00:00,20181.7,2022-11-08 16:00:00,20181.7,-517.8,495586.8499999998,395586.8499999998
2022-11-08 17:15:00,19829.9,2022-11-08 19:30:00,18161.9,1668.0,497254.8499999998,397254.8499999998
2022-11-08 19:45:00,18238.0,2022-11-09 02:30:00,18181.8,-56.2,497198.6499999998,397198.6499999998
2022-11-09 02:45:00,18116.8,2022-11-09 11:45:00,17800.4,316.4,497515.0499999998,397515.0499999998
2022-11-09 12:00:00,17962.2,2022-11-09 15:15:00,17625.2,-337.0,497178.0499999998,397178.0499999998
2022-11-09 15:30:00,17160.1,2022-11-10 02:15:00,16115.5,1044.6,498222.6499999998,398222.6499999998
2022-11-10 02:30:00,16220.1,2022-11-10 10:30:00,16486.1,266.0,498488.6499999998,398488.6499999998
2022-11-10 10:45:00,16396.4,2022-11-10 13:15:00,16625.9,-229.5,498259.1499999998,398259.1499999998
2022-11-10 13:30:00,17349.1,2022-11-10 13:30:00,17349.1,-739.42,497519.7299999998,397519.7299999998
2022-11-10 17:45:00,17179.7,2022-11-10 20:30:00,17476.6,-296.9,497222.8299999998,397222.8299999998
2022-11-10 20:45:00,18101.2,2022-11-10 23:00:00,17724.2,-377.0,496845.8299999998,396845.8299999998
2022-11-10 23:15:00,17532.3,2022-11-11 05:30:00,17226.6,305.7,497151.5299999998,397151.5299999998
2022-11-11 05:45:00,17352.1,2022-11-11 13:45:00,17295.0,-57.1,497094.4299999998,397094.4299999998
2022-11-11 14:00:00,17062.3,2022-11-11 17:45:00,16899.4,162.9,497257.32999999984,397257.32999999984
2022-11-11 18:00:00,16980.8,2022-11-12 04:00:00,16874.6,-106.2,497151.12999999983,397151.12999999983
2022-11-12 04:15:00,16781.4,2022-11-12 09:15:00,16853.2,-71.8,497079.32999999984,397079.32999999984
2022-11-12 09:30:00,16889.4,2022-11-12 20:15:00,16855.9,-33.5,497045.82999999984,397045.82999999984
2022-11-12 20:30:00,16816.2,2022-11-13 02:00:00,16863.9,-47.7,496998.12999999983,396998.12999999983
2022-11-13 02:15:00,16888.4,2022-11-13 06:00:00,16855.9,-32.5,496965.62999999983,396965.62999999983
2022-11-13 06:15:00,16800.2,2022-11-13 07:15:00,16687.7,112.5,497078.12999999983,397078.12999999983
2022-11-13 07:30:00,16746.6,2022-11-13 08:45:00,16643.7,-102.9,496975.2299999998,396975.2299999998
2022-11-13 09:00:00,16505.4,2022-11-13 11:00:00,16563.2,-57.8,496917.4299999998,396917.4299999998
2022-11-13 11:15:00,16662.0,2022-11-13 16:45:00,16578.1,-83.9,496833.5299999998,396833.5299999998
2022-11-13 17:00:00,16510.0,2022-11-13 22:15:00,16408.7,101.3,496934.8299999998,396934.8299999998
2022-11-13 22:30:00,16433.0,2022-11-14 00:15:00,16199.8,-282.0,496652.8299999998,396652.8299999998
2022-11-14 01:15:00,16164.6,2022-11-14 06:15:00,15952.0,212.6,496865.42999999976,396865.42999999976
2022-11-14 06:30:00,16388.7,2022-11-14 06:30:00,16388.7,-439.23,496426.1999999998,396426.1999999998
2022-11-14 14:15:00,16599.4,2022-11-14 22:45:00,16398.0,201.4,496627.5999999998,396627.5999999998
2022-11-14 23:00:00,16549.2,2022-11-15 05:30:00,16664.1,114.9,496742.4999999998,396742.4999999998
2022-11-15 05:45:00,16647.8,2022-11-15 07:15:00,16809.6,-231.8,496510.69999999984,396510.69999999984
2022-11-15 08:15:00,16936.9,2022-11-15 18:00:00,16954.0,17.1,496527.7999999998,396527.7999999998
2022-11-15 18:15:00,16849.4,2022-11-15 21:30:00,16846.5,2.9,496530.69999999984,396530.69999999984
2022-11-15 21:45:00,16896.3,2022-11-16 05:45:00,16911.7,15.4,496546.09999999986,396546.09999999986
2022-11-16 06:00:00,16833.8,2022-11-16 17:45:00,16565.9,267.9,496813.9999999999,396813.9999999999
2022-11-16 18:00:00,16626.7,2022-11-17 02:30:00,16670.1,43.4,496857.3999999999,396857.3999999999
2022-11-17 02:45:00,16567.7,2022-11-17 05:30:00,16554.2,13.5,496870.8999999999,396870.8999999999
2022-11-17 05:45:00,16570.8,2022-11-17 13:15:00,16507.9,-148.71,496722.1899999999,396722.1899999999
2022-11-18 04:00:00,16784.7,2022-11-18 10:00:00,16773.4,11.3,496733.4899999999,396733.4899999999
2022-11-18 10:15:00,16794.6,2022-11-18 14:15:00,16766.2,-28.4,496705.08999999985,396705.08999999985
2022-11-18 14:30:00,16678.6,2022-11-18 22:30:00,16630.4,48.2,496753.28999999986,396753.28999999986
2022-11-18 22:45:00,16659.2,2022-11-19 01:45:00,16657.7,-1.5,496751.78999999986,396751.78999999986
2022-11-19 02:00:00,16617.4,2022-11-19 08:30:00,16617.7,-0.3,496751.4899999999,396751.4899999999
2022-11-19 08:45:00,16636.0,2022-11-19 17:00:00,16635.9,-0.1,496751.3899999999,396751.3899999999
2022-11-19 17:15:00,16618.4,2022-11-19 21:15:00,16641.9,-23.5,496727.8899999999,396727.8899999999
2022-11-19 21:30:00,16652.1,2022-11-19 23:00:00,16747.9,95.8,496823.6899999999,396823.6899999999
2022-11-19 23:15:00,16716.7,2022-11-20 10:00:00,16631.3,85.4,496909.0899999999,396909.0899999999
2022-11-20 10:15:00,16641.0,2022-11-20 11:15:00,16603.8,-37.2,496871.8899999999,396871.8899999999
2022-11-20 11:30:00,16532.6,2022-11-20 16:30:00,16549.2,-16.6,496855.2899999999,396855.2899999999
2022-11-20 16:45:00,16575.8,2022-11-20 20:15:00,16496.5,-112.92,496742.36999999994,396742.36999999994
2022-11-20 21:30:00,16430.6,2022-11-21 03:45:00,16067.2,363.4,497105.76999999996,397105.76999999996
2022-11-21 04:00:00,16178.6,2022-11-21 06:30:00,16142.2,-36.4,497069.36999999994,397069.36999999994
2022-11-21 06:45:00,16085.0,2022-11-21 12:45:00,16108.6,-23.6,497045.76999999996,397045.76999999996
2022-11-21 13:00:00,16174.8,2022-11-21 16:00:00,16088.1,-86.7,496959.06999999995,396959.06999999995
2022-11-21 16:15:00,15996.1,2022-11-21 22:45:00,15729.1,267.0,497226.06999999995,397226.06999999995
2022-11-21 23:00:00,15822.7,2022-11-22 06:00:00,15768.5,-54.2,497171.86999999994,397171.86999999994
2022-11-22 06:15:00,15740.6,2022-11-22 10:30:00,15721.5,19.1,497190.9699999999,397190.9699999999
2022-11-22 10:45:00,15791.1,2022-11-22 17:30:00,16110.0,318.9,497509.86999999994,397509.86999999994
2022-11-22 17:45:00,16073.4,2022-11-22 23:00:00,16176.8,-103.4,497406.4699999999,397406.4699999999
2022-11-22 23:15:00,16220.1,2022-11-23 12:15:00,16533.0,312.9,497719.36999999994,397719.36999999994
2022-11-23 12:30:00,16512.9,2022-11-23 18:30:00,16451.8,61.1,497780.4699999999,397780.4699999999
2022-11-23 18:45:00,16521.0,2022-11-23 19:00:00,16594.2,73.2,497853.6699999999,397853.6699999999
2022-11-23 19:15:00,16418.8,2022-11-23 23:15:00,16565.0,-146.2,497707.4699999999,397707.4699999999
2022-11-23 23:30:00,16609.9,2022-11-24 07:30:00,16699.6,89.7,497797.1699999999,397797.1699999999
2022-11-24 07:45:00,16613.8,2022-11-24 15:45:00,16549.0,64.8,497861.9699999999,397861.9699999999
2022-11-24 16:00:00,16634.8,2022-11-24 20:45:00,16558.7,-76.1,497785.86999999994,397785.86999999994
2022-11-24 21:00:00,16546.1,2022-11-25 07:15:00,16428.1,118.0,497903.86999999994,397903.86999999994
2022-11-25 07:30:00,16451.8,2022-11-25 13:45:00,16483.6,31.8,497935.6699999999,397935.6699999999
2022-11-25 14:00:00,16446.8,2022-11-25 20:00:00,16512.8,-66.0,497869.6699999999,397869.6699999999
2022-11-25 20:15:00,16554.1,2022-11-25 20:30:00,16550.4,-3.7,497865.9699999999,397865.9699999999
2022-11-25 20:45:00,16518.9,2022-11-26 00:45:00,16570.6,-51.7,497814.2699999999,397814.2699999999
2022-11-26 01:00:00,16604.0,2022-11-26 05:45:00,16614.6,10.6,497824.8699999999,397824.8699999999
2022-11-26 06:00:00,16563.5,2022-11-26 09:45:00,16581.3,-17.8,497807.0699999999,397807.0699999999
2022-11-26 10:00:00,16609.5,2022-11-26 14:30:00,16617.5,8.0,497815.0699999999,397815.0699999999
2022-11-26 14:45:00,16561.8,2022-11-26 20:30:00,16486.5,75.3,497890.3699999999,397890.3699999999
2022-11-26 20:45:00,16491.7,2022-11-26 22:15:00,16483.5,-8.2,497882.16999999987,397882.16999999987
2022-11-26 22:30:00,16413.9,2022-11-27 00:00:00,16456.7,-42.8,497839.3699999999,397839.3699999999
2022-11-27 00:15:00,16477.0,2022-11-27 09:30:00,16530.2,53.2,497892.5699999999,397892.5699999999
2022-11-27 09:45:00,16513.8,2022-11-27 20:45:00,16550.4,-36.6,497855.9699999999,397855.9699999999
2022-11-27 21:00:00,16560.9,2022-11-27 22:45:00,16565.4,4.5,497860.4699999999,397860.4699999999
2022-11-27 23:00:00,16493.8,2022-11-28 04:00:00,16195.5,298.3,498158.7699999999,398158.7699999999
2022-11-28 04:15:00,16222.2,2022-11-28 15:00:00,16188.1,-34.1,498124.6699999999,398124.6699999999
2022-11-28 15:15:00,16145.5,2022-11-28 16:15:00,16090.0,55.5,498180.1699999999,398180.1699999999
2022-11-28 16:30:00,16210.1,2022-11-28 18:15:00,16184.1,-26.0,498154.1699999999,398154.1699999999
2022-11-28 18:30:00,16162.4,2022-11-29 01:15:00,16173.6,-11.2,498142.9699999999,398142.9699999999
2022-11-29 01:30:00,16231.0,2022-11-29 13:00:00,16461.9,230.9,498373.86999999994,398373.86999999994
2022-11-29 13:15:00,16443.6,2022-11-29 18:45:00,16413.3,30.3,498404.1699999999,398404.1699999999
2022-11-29 19:00:00,16436.3,2022-11-30 03:30:00,16896.1,459.8,498863.9699999999,398863.9699999999
2022-11-30 03:45:00,16836.7,2022-11-30 13:00:00,16824.9,11.8,498875.7699999999,398875.7699999999
2022-11-30 13:15:00,16879.3,2022-11-30 17:15:00,16757.8,-146.45,498729.3199999999,398729.3199999999
2022-11-30 18:15:00,16734.0,2022-11-30 18:30:00,16867.6,-191.85,498537.4699999999,398537.4699999999
2022-11-30 18:45:00,16913.4,2022-12-01 05:00:00,17140.1,226.7,498764.1699999999,398764.1699999999
2022-12-01 05:15:00,17134.9,2022-12-01 11:45:00,17096.9,38.0,498802.1699999999,398802.1699999999
2022-12-01 12:00:00,17119.1,2022-12-01 13:30:00,17125.6,6.5,498808.6699999999,398808.6699999999
2022-12-01 13:45:00,17082.0,2022-12-01 23:30:00,16949.0,133.0,498941.6699999999,398941.6699999999
2022-12-01 23:45:00,16970.5,2022-12-02 01:30:00,16939.1,-31.4,498910.2699999999,398910.2699999999
2022-12-02 01:45:00,16917.0,2022-12-02 06:00:00,16920.1,-3.1,498907.1699999999,398907.1699999999
2022-12-02 06:15:00,16935.0,2022-12-02 13:15:00,17014.5,79.5,498986.6699999999,398986.6699999999
2022-12-02 13:30:00,16877.5,2022-12-02 14:15:00,16885.4,-7.9,498978.7699999999,398978.7699999999
2022-12-02 14:30:00,16924.0,2022-12-03 00:15:00,17051.7,127.7,499106.4699999999,399106.4699999999
2022-12-03 00:30:00,17043.1,2022-12-03 12:30:00,16928.3,114.8,499221.2699999999,399221.2699999999
2022-12-03 12:45:00,16957.8,2022-12-03 20:45:00,16927.6,-48.61,499172.6599999999,399172.6599999999
2022-12-03 21:00:00,16902.5,2022-12-03 21:30:00,16911.8,-9.3,499163.3599999999,399163.3599999999
2022-12-03 21:45:00,16941.5,2022-12-03 22:30:00,16876.1,-75.72,499087.63999999996,399087.63999999996
2022-12-04 03:15:00,16952.0,2022-12-04 04:45:00,16999.3,-47.3,499040.33999999997,399040.33999999997
2022-12-04 05:00:00,17052.1,2022-12-04 07:00:00,16995.8,-56.3,498984.04,398984.04
2022-12-04 07:15:00,16996.1,2022-12-04 14:30:00,16950.4,45.7,499029.74,399029.74
2022-12-04 14:45:00,16998.8,2022-12-04 16:45:00,17006.0,7.2,499036.94,399036.94
2022-12-04 17:00:00,16974.0,2022-12-04 17:45:00,17044.3,-70.3,498966.64,398966.64
2022-12-04 18:00:00,17088.6,2022-12-05 03:15:00,17226.4,137.8,499104.44,399104.44
2022-12-05 03:30:00,17191.0,2022-12-05 04:45:00,17346.0,-171.85,498932.59,398932.59
2022-12-05 07:30:00,17328.1,2022-12-05 12:15:00,17262.6,-65.5,498867.09,398867.09
2022-12-05 12:30:00,17237.8,2022-12-05 23:45:00,16958.3,279.5,499146.59,399146.59
2022-12-06 00:00:00,16990.1,2022-12-06 03:45:00,16995.4,5.3,499151.89,399151.89
2022-12-06 04:00:00,16986.3,2022-12-06 12:15:00,16982.0,4.3,499156.19,399156.19
2022-12-06 12:30:00,16996.8,2022-12-07 02:45:00,17046.7,49.9,499206.09,399206.09
2022-12-07 03:00:00,17033.5,2022-12-07 09:00:00,16788.0,245.5,499451.59,399451.59
2022-12-07 09:15:00,16812.6,2022-12-07 18:30:00,16798.5,-14.1,499437.49000000005,399437.49000000005
2022-12-07 18:45:00,16775.2,2022-12-07 22:15:00,16813.5,-70.87,499366.62000000005,399366.62000000005
2022-12-08 00:15:00,16854.1,2022-12-08 01:15:00,16818.2,-35.9,499330.72000000003,399330.72000000003
2022-12-08 01:30:00,16777.8,2022-12-08 02:30:00,16861.1,-93.94,499236.78,399236.78
2022-12-08 12:00:00,16831.8,2022-12-08 23:45:00,17248.98,417.18,499653.96,399653.96
2022-12-09 05:15:00,17195.9,2022-12-09 10:00:00,17220.0,-59.7,499594.26,399594.26
2022-12-09 17:45:00,17156.5,2022-12-09 21:00:00,17101.0,-85.58,499508.68,399508.68
2022-12-10 09:00:00,17129.3,2022-12-10 09:45:00,17137.0,-7.7,499500.98,399500.98
2022-12-10 10:00:00,17150.6,2022-12-10 13:45:00,17149.7,-0.9,499500.07999999996,399500.07999999996
2022-12-10 14:00:00,17140.1,2022-12-10 15:15:00,17182.0,-55.94,499444.13999999996,399444.13999999996
2022-12-10 15:45:00,17200.3,2022-12-10 17:30:00,17173.8,-26.5,499417.63999999996,399417.63999999996
2022-12-10 17:45:00,17158.6,2022-12-11 00:30:00,17127.6,31.0,499448.63999999996,399448.63999999996
2022-12-11 00:45:00,17134.4,2022-12-11 10:00:00,17150.0,15.6,499464.23999999993,399464.23999999993
2022-12-11 10:15:00,17143.8,2022-12-11 17:00:00,17158.2,-14.4,499449.8399999999,399449.8399999999
2022-12-11 17:15:00,17167.0,2022-12-11 19:15:00,17224.1,57.1,499506.9399999999,399506.9399999999
2022-12-11 19:30:00,17163.3,2022-12-12 04:45:00,16918.21,245.09,499752.0299999999,399752.0299999999
2022-12-12 05:45:00,16938.1,2022-12-12 21:00:00,17188.95,250.85,500002.8799999999,400002.8799999999
2022-12-13 01:30:00,17144.4,2022-12-13 06:00:00,17169.9,-25.5,499977.3799999999,399977.3799999999
2022-12-13 06:15:00,17185.3,2022-12-13 06:45:00,17143.7,-41.6,499935.7799999999,399935.7799999999
2022-12-13 07:00:00,17109.2,2022-12-13 08:00:00,17150.3,-41.1,499894.67999999993,399894.67999999993
2022-12-13 08:15:00,17172.6,2022-12-13 13:30:00,18070.56,897.96,500792.63999999996,400792.63999999996
2022-12-13 15:15:00,17761.4,2022-12-13 21:30:00,17757.8,3.6,500796.23999999993,400796.23999999993
2022-12-13 21:45:00,17767.3,2022-12-14 18:45:00,18215.0,447.7,501243.93999999994,401243.93999999994
2022-12-14 19:00:00,17934.5,2022-12-14 19:00:00,17934.5,-427.42,500816.51999999996,400816.51999999996
2022-12-15 03:30:00,17745.1,2022-12-15 08:15:00,17650.8,-106.93,500709.58999999997,400709.58999999997
2022-12-15 08:45:00,17621.3,2022-12-15 11:30:00,17684.8,-63.5,500646.08999999997,400646.08999999997
2022-12-15 11:45:00,17712.1,2022-12-15 12:45:00,17674.7,-37.4,500608.68999999994,400608.68999999994
2022-12-15 13:00:00,17564.8,2022-12-15 20:00:00,17431.1,133.7,500742.38999999996,400742.38999999996
2022-12-15 20:15:00,17443.4,2022-12-15 22:15:00,17340.0,-143.88,500598.50999999995,400598.50999999995
2022-12-16 08:45:00,17215.0,2022-12-16 08:45:00,17215.0,-147.54,500450.97,400450.97
2022-12-16 20:00:00,16867.4,2022-12-16 22:15:00,16845.1,-22.3,500428.67,400428.67
2022-12-16 22:30:00,16732.1,2022-12-17 03:45:00,16667.5,64.6,500493.26999999996,400493.26999999996
2022-12-17 04:00:00,16678.3,2022-12-17 13:00:00,16686.0,7.7,500500.97,400500.97
2022-12-17 13:15:00,16656.5,2022-12-17 20:45:00,16692.6,-36.1,500464.87,400464.87
2022-12-17 21:00:00,16710.4,2022-12-18 01:00:00,16719.6,9.2,500474.07,400474.07
2022-12-18 01:15:00,16703.0,2022-12-18 03:45:00,16736.5,-33.5,500440.57,400440.57
2022-12-18 04:00:00,16761.9,2022-12-18 05:45:00,16732.0,-29.9,500410.67,400410.67
2022-12-18 06:00:00,16730.7,2022-12-18 12:45:00,16716.0,14.7,500425.37,400425.37
2022-12-18 13:00:00,16716.6,2022-12-18 22:30:00,16786.3,69.7,500495.07,400495.07
2022-12-18 22:45:00,16753.9,2022-12-19 06:30:00,16698.5,55.4,500550.47000000003,400550.47000000003
2022-12-19 06:45:00,16729.5,2022-12-19 13:30:00,16710.6,-18.9,500531.57,400531.57
2022-12-19 13:45:00,16701.8,2022-12-19 21:00:00,16597.3,104.5,500636.07,400636.07
2022-12-19 21:15:00,16629.4,2022-12-19 22:15:00,16551.9,-77.5,500558.57,400558.57
2022-12-19 22:30:00,16389.1,2022-12-19 22:30:00,16389.1,0.0,500558.57,400558.57
2022-12-19 22:45:00,16407.4,2022-12-20 08:45:00,16829.96,422.56,500981.13,400981.13
2022-12-20 16:15:00,16793.5,2022-12-20 20:00:00,16885.4,-91.9,500889.23,400889.23
2022-12-20 20:15:00,16916.7,2022-12-21 03:00:00,16817.3,-115.87,500773.36,400773.36
2022-12-21 03:15:00,16804.9,2022-12-21 08:30:00,16837.7,-32.8,500740.56,400740.56
2022-12-21 08:45:00,16856.8,2022-12-21 14:45:00,16789.0,-119.42,500621.14,400621.14
2022-12-21 16:30:00,16805.4,2022-12-21 23:30:00,16795.3,10.1,500631.24,400631.24
2022-12-21 23:45:00,16819.6,2022-12-22 12:45:00,16808.3,-11.3,500619.94,400619.94
2022-12-22 13:00:00,16797.2,2022-12-22 19:30:00,16640.5,156.7,500776.64,400776.64
2022-12-22 19:45:00,16658.3,2022-12-23 05:15:00,16821.8,163.5,500940.14,400940.14
2022-12-23 05:30:00,16816.9,2022-12-23 10:30:00,16845.1,-64.7,500875.44,400875.44
2022-12-23 12:15:00,16857.4,2022-12-23 13:30:00,16881.8,24.4,500899.84,400899.84
2022-12-23 13:45:00,16833.5,2022-12-23 19:00:00,16842.3,-8.8,500891.04000000004,400891.04000000004
2022-12-23 19:15:00,16845.5,2022-12-23 22:00:00,16785.3,-60.2,500830.84,400830.84
2022-12-23 22:15:00,16780.7,2022-12-24 02:30:00,16813.0,-32.3,500798.54000000004,400798.54000000004
2022-12-24 02:45:00,16818.8,2022-12-24 11:30:00,16822.1,3.3,500801.84,400801.84
2022-12-24 11:45:00,16819.2,2022-12-24 16:45:00,16829.6,-10.4,500791.44,400791.44
2022-12-24 17:00:00,16833.3,2022-12-24 19:45:00,16834.6,1.3,500792.74,400792.74
2022-12-24 20:00:00,16830.5,2022-12-25 00:15:00,16830.5,0.0,500792.74,400792.74
2022-12-25 00:30:00,16838.3,2022-12-25 04:00:00,16820.1,-18.2,500774.54,400774.54
2022-12-25 04:15:00,16820.3,2022-12-25 05:30:00,16815.7,4.6,500779.13999999996,400779.13999999996
2022-12-25 05:45:00,16825.2,2022-12-25 13:00:00,16810.4,-14.8,500764.33999999997,400764.33999999997
2022-12-25 13:15:00,16809.2,2022-12-25 14:30:00,16791.1,18.1,500782.43999999994,400782.43999999994
2022-12-25 14:45:00,16823.6,2022-12-25 14:45:00,16823.6,-53.23,500729.20999999996,400729.20999999996
2022-12-25 17:45:00,16786.8,2022-12-25 21:00:00,16765.8,21.0,500750.20999999996,400750.20999999996
2022-12-25 21:15:00,16793.9,2022-12-26 05:00:00,16873.7,79.8,500830.00999999995,400830.00999999995
2022-12-26 05:15:00,16852.7,2022-12-26 11:00:00,16841.2,11.5,500841.50999999995,400841.50999999995
2022-12-26 11:15:00,16858.0,2022-12-26 14:15:00,16835.2,-22.8,500818.70999999996,400818.70999999996
2022-12-26 14:30:00,16823.2,2022-12-26 16:15:00,16822.5,0.7,500819.41,400819.41
2022-12-26 16:30:00,16831.0,2022-12-27 00:15:00,16902.6,71.6,500891.00999999995,400891.00999999995
2022-12-27 00:30:00,16870.5,2022-12-27 06:30:00,16869.2,1.3,500892.30999999994,400892.30999999994
2022-12-27 06:45:00,16882.4,2022-12-27 11:00:00,16846.0,-36.4,500855.9099999999,400855.9099999999
2022-12-27 11:15:00,16820.5,2022-12-27 15:00:00,16775.5,45.0,500900.9099999999,400900.9099999999
2022-12-27 15:15:00,16819.1,2022-12-27 17:00:00,16771.2,-47.9,500853.0099999999,400853.0099999999
2022-12-27 17:15:00,16745.2,2022-12-27 19:45:00,16681.3,63.9,500916.9099999999,400916.9099999999
2022-12-27 20:00:00,16688.1,2022-12-28 02:45:00,16676.4,-11.7,500905.2099999999,400905.2099999999
2022-12-28 03:00:00,16584.7,2022-12-28 03:45:00,16643.3,-58.6,500846.6099999999,400846.6099999999
2022-12-28 04:00:00,16658.7,2022-12-28 15:00:00,16741.6,82.9,500929.50999999995,400929.50999999995
2022-12-28 15:15:00,16648.0,2022-12-29 00:15:00,16548.7,99.3,501028.80999999994,401028.80999999994
2022-12-29 00:30:00,16570.2,2022-12-29 02:00:00,16526.4,-43.8,500985.00999999995,400985.00999999995
2022-12-29 02:15:00,16494.0,2022-12-29 04:30:00,16558.0,-64.0,500921.00999999995,400921.00999999995
2022-12-29 04:45:00,16564.3,2022-12-29 20:00:00,16606.8,42.5,500963.50999999995,400963.50999999995
2022-12-29 20:15:00,16591.9,2022-12-29 22:45:00,16614.0,-22.1,500941.41,400941.41
2022-12-29 23:00:00,16636.1,2022-12-30 02:00:00,16604.5,-31.6,500909.81,400909.81
2022-12-30 02:15:00,16595.2,2022-12-30 08:45:00,16493.0,102.2,501012.01,401012.01
2022-12-30 09:00:00,16502.0,2022-12-30 13:30:00,16468.8,-33.2,500978.81,400978.81
2022-12-30 13:45:00,16462.0,2022-12-30 14:45:00,16407.0,55.0,501033.81,401033.81
2022-12-30 15:00:00,16445.1,2022-12-30 22:00:00,16585.3,140.2,501174.01,401174.01
2022-12-30 22:15:00,16579.8,2022-12-31 08:15:00,16553.9,25.9,501199.91000000003,401199.91000000003
2022-12-31 08:30:00,16573.4,2022-12-31 09:30:00,16544.1,-29.3,501170.61000000004,401170.61000000004
2022-12-31 09:45:00,16544.0,2022-12-31 13:00:00,16579.3,-35.3,501135.31000000006,401135.31000000006
2022-12-31 13:15:00,16583.4,2022-12-31 14:30:00,16605.1,21.7,501157.01000000007,401157.01000000007
2022-12-31 14:45:00,16584.8,2022-12-31 23:15:00,16520.9,63.9,501220.9100000001,401220.9100000001
2022-12-31 23:30:00,16542.5,2023-01-01 04:45:00,16517.8,-24.7,501196.2100000001,401196.2100000001
2023-01-01 05:00:00,16511.7,2023-01-01 09:30:00,16526.4,-14.7,501181.51000000007,401181.51000000007
2023-01-01 09:45:00,16532.7,2023-01-01 14:30:00,16540.5,7.8,501189.31000000006,401189.31000000006
2023-01-01 14:45:00,16533.1,2023-01-01 16:00:00,16554.8,-36.06,501153.25000000006,401153.25000000006
2023-01-01 16:15:00,16572.2,2023-01-02 00:45:00,16578.0,5.8,501159.05000000005,401159.05000000005
2023-01-02 01:00:00,16558.5,2023-01-02 03:15:00,16575.9,-17.4,501141.65,401141.65
2023-01-02 03:30:00,16598.8,2023-01-02 04:00:00,16635.9,37.1,501178.75,401178.75
2023-01-02 04:15:00,16633.8,2023-01-02 06:45:00,16632.4,1.4,501180.15,401180.15
2023-01-02 07:00:00,16692.1,2023-01-02 13:00:00,16710.9,18.8,501198.95,401198.95
2023-01-02 13:15:00,16710.8,2023-01-02 15:15:00,16710.6,0.2,501199.15,401199.15
2023-01-02 15:30:00,16737.4,2023-01-02 18:15:00,16708.0,-29.4,501169.75,401169.75
2023-01-02 18:30:00,16704.1,2023-01-02 21:45:00,16751.9,-50.69,501119.06,401119.06
2023-01-03 05:00:00,16691.0,2023-01-03 07:00:00,16720.3,29.3,501148.36,401148.36
2023-01-03 07:15:00,16707.9,2023-01-03 14:15:00,16736.1,-28.2,501120.16,401120.16
2023-01-03 14:30:00,16747.1,2023-01-03 14:30:00,16747.1,0.0,501120.16,401120.16
2023-01-03 14:45:00,16653.1,2023-01-03 14:45:00,16653.1,-76.55,501043.61,401043.61
2023-01-03 21:15:00,16662.0,2023-01-04 09:45:00,16838.9,176.9,501220.51,401220.51
2023-01-04 10:00:00,16829.6,2023-01-04 15:30:00,16825.1,4.5,501225.01,401225.01
2023-01-04 15:45:00,16846.5,2023-01-04 19:00:00,16868.9,22.4,501247.41000000003,401247.41000000003
2023-01-04 19:15:00,16804.7,2023-01-04 23:45:00,16842.1,-37.4,501210.01,401210.01
2023-01-05 00:00:00,16856.0,2023-01-05 05:45:00,16836.1,-19.9,501190.11,401190.11
2023-01-05 06:00:00,16830.5,2023-01-05 10:45:00,16816.4,14.1,501204.20999999996,401204.20999999996
2023-01-05 11:00:00,16818.1,2023-01-05 13:30:00,16789.8,-28.3,501175.91,401175.91
2023-01-05 13:45:00,16771.1,2023-01-05 14:00:00,16796.7,-25.6,501150.31,401150.31
2023-01-05 14:15:00,16805.0,2023-01-05 23:00:00,16831.4,26.4,501176.71,401176.71
2023-01-05 23:15:00,16821.0,2023-01-06 13:30:00,16774.1,46.9,501223.61000000004,401223.61000000004
2023-01-06 13:45:00,16766.9,2023-01-06 20:30:00,16932.3,165.4,501389.01000000007,401389.01000000007
2023-01-06 20:45:00,16888.7,2023-01-07 00:30:00,16956.8,-68.1,501320.9100000001,401320.9100000001
2023-01-07 00:45:00,16970.0,2023-01-07 04:45:00,16930.0,-40.0,501280.9100000001,401280.9100000001
2023-01-07 05:00:00,16930.7,2023-01-07 14:15:00,16920.5,10.2,501291.1100000001,401291.1100000001
2023-01-07 14:30:00,16935.6,2023-01-07 16:15:00,16918.8,-16.8,501274.3100000001,401274.3100000001
2023-01-07 16:30:00,16912.0,2023-01-07 19:00:00,16931.5,-19.5,501254.8100000001,401254.8100000001
2023-01-07 19:15:00,16933.6,2023-01-08 00:15:00,16931.1,-2.5,501252.3100000001,401252.3100000001
2023-01-08 00:30:00,16914.6,2023-01-08 03:15:00,16925.5,-10.9,501241.4100000001,401241.4100000001
2023-01-08 03:30:00,16932.3,2023-01-08 09:30:00,16921.2,-11.1,501230.3100000001,401230.3100000001
2023-01-08 09:45:00,16927.4,2023-01-08 14:00:00,16928.2,-0.8,501229.5100000001,401229.5100000001
2023-01-08 14:15:00,16934.1,2023-01-08 15:45:00,16991.0,56.9,501286.41000000015,401286.41000000015
2023-01-08 16:00:00,16958.6,2023-01-08 16:00:00,16958.6,-49.3,501237.11000000016,401237.11000000016
2023-01-08 20:30:00,16966.0,2023-01-09 07:45:00,17190.79,224.79,501461.90000000014,401461.90000000014
2023-01-09 20:00:00,17231.1,2023-01-10 01:45:00,17187.2,43.9,501505.80000000016,401505.80000000016
2023-01-10 02:00:00,17206.6,2023-01-10 12:30:00,17228.3,21.7,501527.5000000002,401527.5000000002
2023-01-10 12:45:00,17216.1,2023-01-10 13:45:00,17238.7,-22.6,501504.9000000002,401504.9000000002
2023-01-10 14:00:00,17280.0,2023-01-11 02:30:00,17413.1,133.1,501638.0000000002,401638.0000000002
2023-01-11 02:45:00,17380.0,2023-01-11 06:45:00,17427.1,-47.1,501590.9000000002,401590.9000000002
2023-01-11 07:00:00,17430.0,2023-01-11 12:00:00,17415.8,-14.2,501576.7000000002,401576.7000000002
2023-01-11 12:15:00,17402.1,2023-01-11 17:45:00,17373.3,28.8,501605.5000000002,401605.5000000002
2023-01-11 18:00:00,17511.4,2023-01-11 18:00:00,17511.4,-107.41,501498.0900000002,401498.0900000002
2023-01-12 04:15:00,18191.4,2023-01-12 11:15:00,18166.4,25.0,501523.0900000002,401523.0900000002
2023-01-12 11:30:00,18198.4,2023-01-12 13:30:00,18149.9,-269.54,501253.5500000002,401253.5500000002
2023-01-12 14:30:00,17976.9,2023-01-12 17:00:00,18141.3,-164.4,501089.1500000002,401089.1500000002
2023-01-12 17:15:00,18245.0,2023-01-13 00:15:00,18838.3,593.3,501682.4500000002,401682.4500000002
2023-01-13 00:30:00,18711.0,2023-01-13 06:30:00,18837.4,-126.4,501556.05000000016,401556.05000000016
2023-01-13 06:45:00,18844.0,2023-01-13 12:15:00,18884.5,40.5,501596.55000000016,401596.55000000016
2023-01-13 12:30:00,18862.9,2023-01-13 14:45:00,18990.1,-218.54,501378.0100000002,401378.0100000002
2023-01-13 15:00:00,19122.9,2023-01-14 00:30:00,21208.08,2085.18,503463.1900000002,403463.1900000002
2023-01-14 01:15:00,20734.3,2023-01-14 08:15:00,20966.2,-231.9,503231.29000000015,403231.29000000015
2023-01-14 08:30:00,21036.6,2023-01-14 09:00:00,20842.0,-194.6,503036.6900000002,403036.6900000002
2023-01-14 09:15:00,20585.4,2023-01-14 11:00:00,20718.5,-133.1,502903.5900000002,402903.5900000002
2023-01-14 11:15:00,20723.9,2023-01-14 15:15:00,20818.9,95.0,502998.5900000002,402998.5900000002
2023-01-14 15:30:00,20728.1,2023-01-14 20:45:00,20895.0,-166.9,502831.6900000002,402831.6900000002
2023-01-14 21:00:00,20948.4,2023-01-15 00:15:00,20927.3,-21.1,502810.5900000002,402810.5900000002
2023-01-15 00:30:00,20665.4,2023-01-15 06:00:00,20738.0,-72.6,502737.9900000002,402737.9900000002
2023-01-15 06:15:00,20775.6,2023-01-15 17:45:00,20931.0,155.4,502893.39000000025,402893.39000000025
2023-01-15 18:00:00,20788.0,2023-01-15 20:15:00,20877.4,-89.4,502803.9900000002,402803.9900000002
2023-01-15 20:30:00,20887.9,2023-01-16 03:15:00,21131.4,243.5,503047.4900000002,403047.4900000002
2023-01-16 03:30:00,21050.1,2023-01-16 11:45:00,20821.7,228.4,503275.89000000025,403275.89000000025
2023-01-16 12:00:00,20861.6,2023-01-16 15:00:00,20672.7,-246.41,503029.4800000003,403029.4800000003
2023-01-16 21:15:00,21123.0,2023-01-17 03:15:00,21096.0,27.0,503056.4800000003,403056.4800000003
2023-01-17 03:30:00,21137.6,2023-01-17 14:15:00,21276.8,139.2,503195.6800000003,403195.6800000003
2023-01-17 14:30:00,21150.6,2023-01-17 18:30:00,21320.6,-170.0,503025.6800000003,403025.6800000003
2023-01-17 18:45:00,21361.9,2023-01-17 23:15:00,21215.3,-146.6,502879.0800000003,402879.0800000003
2023-01-17 23:30:00,21162.8,2023-01-18 02:45:00,21292.9,-130.1,502748.98000000033,402748.98000000033
2023-01-18 03:00:00,21347.1,2023-01-18 09:00:00,21246.5,-168.46,502580.5200000003,402580.5200000003
2023-01-18 09:30:00,21181.3,2023-01-18 13:30:00,21317.0,-173.04,502407.48000000033,402407.48000000033
2023-01-18 13:45:00,21401.2,2023-01-18 14:15:00,21399.9,-1.3,502406.18000000034,402406.18000000034
2023-01-18 14:30:00,21351.4,2023-01-18 16:45:00,20851.3,500.1,502906.2800000003,402906.2800000003
2023-01-18 17:00:00,21079.0,2023-01-18 21:45:00,20780.7,-298.3,502607.98000000033,402607.98000000033
2023-01-18 22:00:00,20705.7,2023-01-19 04:00:00,20793.5,-87.8,502520.18000000034,402520.18000000034
2023-01-19 04:15:00,20827.2,2023-01-19 11:00:00,20760.0,-67.2,502452.98000000033,402452.98000000033
2023-01-19 11:15:00,20728.1,2023-01-19 15:00:00,20846.1,-192.22,502260.76000000036,402260.76000000036
2023-01-19 15:15:00,20903.1,2023-01-19 21:15:00,21040.8,137.7,502398.46000000037,402398.46000000037
2023-01-19 21:30:00,20972.0,2023-01-20 01:00:00,21060.4,-88.4,502310.06000000035,402310.06000000035
2023-01-20 01:15:00,21126.6,2023-01-20 04:15:00,21121.6,-5.0,502305.06000000035,402305.06000000035
2023-01-20 04:30:00,21032.5,2023-01-20 11:45:00,20957.6,74.9,502379.96000000037,402379.96000000037
2023-01-20 12:00:00,20996.5,2023-01-20 21:45:00,22334.49,1337.99,503717.95000000036,403717.95000000036
2023-01-21 05:00:00,22574.1,2023-01-21 08:15:00,22666.5,-92.4,503625.55000000034,403625.55000000034
2023-01-21 08:30:00,22757.9,2023-01-21 10:00:00,23304.9,547.0,504172.55000000034,404172.55000000034
2023-01-21 10:15:00,22785.2,2023-01-21 10:15:00,22785.2,-477.03,503695.5200000003,403695.5200000003
2023-01-21 12:45:00,23036.8,2023-01-21 22:00:00,23123.0,86.2,503781.7200000003,403781.7200000003
2023-01-21 22:15:00,23056.9,2023-01-22 05:15:00,22859.9,197.0,503978.7200000003,403978.7200000003
2023-01-22 05:30:00,22881.2,2023-01-22 11:00:00,22860.5,-20.7,503958.0200000003,403958.0200000003
2023-01-22 11:15:00,22770.0,2023-01-22 13:15:00,22900.0,-130.0,503828.0200000003,403828.0200000003
2023-01-22 13:30:00,22908.2,2023-01-22 15:00:00,23039.1,130.9,503958.92000000033,403958.92000000033
2023-01-22 15:15:00,22774.9,2023-01-22 17:30:00,22893.6,-118.7,503840.2200000003,403840.2200000003
2023-01-22 17:45:00,22924.4,2023-01-22 19:45:00,22720.0,-204.4,503635.8200000003,403635.8200000003
2023-01-22 20:00:00,22532.7,2023-01-22 22:30:00,22561.6,-28.9,503606.9200000003,403606.9200000003
2023-01-22 22:45:00,22674.3,2023-01-23 19:15:00,22847.8,173.5,503780.4200000003,403780.4200000003
2023-01-23 19:30:00,22746.0,2023-01-23 21:15:00,22980.6,-234.6,503545.8200000003,403545.8200000003
2023-01-23 21:30:00,23012.5,2023-01-24 08:45:00,23046.9,34.4,503580.2200000003,403580.2200000003
2023-01-24 09:00:00,22917.1,2023-01-24 12:00:00,22882.1,35.0,503615.2200000003,403615.2200000003
2023-01-24 12:15:00,22989.3,2023-01-24 13:15:00,22950.0,-39.3,503575.92000000033,403575.92000000033
2023-01-24 13:30:00,22819.2,2023-01-24 17:45:00,22905.9,-86.7,503489.2200000003,403489.2200000003
2023-01-24 18:00:00,22993.7,2023-01-24 22:00:00,22891.0,-102.7,503386.5200000003,403386.5200000003
2023-01-24 22:15:00,22689.5,2023-01-25 03:00:00,22591.6,97.9,503484.42000000033,403484.42000000033
2023-01-25 03:15:00,22620.8,2023-01-25 09:45:00,22601.8,-19.0,503465.42000000033,403465.42000000033
2023-01-25 10:00:00,22532.0,2023-01-25 11:45:00,22595.9,-63.9,503401.5200000003,403401.5200000003
2023-01-25 12:00:00,22720.0,2023-01-25 14:15:00,22558.3,-161.7,503239.8200000003,403239.8200000003
2023-01-25 14:30:00,22508.0,2023-01-25 15:45:00,22573.3,-65.3,503174.5200000003,403174.5200000003
2023-01-25 16:00:00,22616.4,2023-01-25 22:30:00,23397.9,781.5,503956.0200000003,403956.0200000003
2023-01-25 22:45:00,22930.1,2023-01-26 02:45:00,23175.0,-244.9,503711.1200000003,403711.1200000003
2023-01-26 03:00:00,23203.7,2023-01-26 06:15:00,22996.5,-272.87,503438.2500000003,403438.2500000003
2023-01-26 07:45:00,22961.3,2023-01-26 12:15:00,23036.5,-75.2,503363.0500000003,403363.0500000003
2023-01-26 12:30:00,23082.6,2023-01-26 20:45:00,23105.8,23.2,503386.2500000003,403386.2500000003
2023-01-26 21:00:00,22987.5,2023-01-27 02:45:00,22772.6,214.9,503601.1500000003,403601.1500000003
2023-01-27 03:00:00,22794.5,2023-01-27 10:45:00,22942.9,148.4,503749.55000000034,403749.55000000034
2023-01-27 11:00:00,22918.8,2023-01-27 14:45:00,22958.4,-39.6,503709.95000000036,403709.95000000036
2023-01-27 15:00:00,23086.5,2023-01-27 20:30:00,23259.0,172.5,503882.45000000036,403882.45000000036
2023-01-27 20:45:00,23104.7,2023-01-28 03:30:00,23108.8,-4.1,503878.3500000004,403878.3500000004
2023-01-28 03:45:00,23109.0,2023-01-28 06:45:00,23031.9,-77.1,503801.2500000004,403801.2500000004
2023-01-28 07:00:00,23000.0,2023-01-28 14:45:00,22941.6,58.4,503859.65000000043,403859.65000000043
2023-01-28 15:00:00,23027.9,2023-01-29 01:30:00,23336.5,308.6,504168.2500000004,404168.2500000004
2023-01-29 01:45:00,23232.0,2023-01-29 05:30:00,23232.0,0.0,504168.2500000004,404168.2500000004
2023-01-29 05:45:00,23244.6,2023-01-29 11:00:00,23434.6,190.0,504358.2500000004,404358.2500000004
2023-01-29 11:15:00,23404.4,2023-01-29 16:30:00,23560.7,-156.3,504201.9500000004,404201.9500000004
2023-01-29 16:45:00,23585.8,2023-01-30 00:00:00,23777.9,192.1,504394.0500000004,404394.0500000004
2023-01-30 00:15:00,23708.9,2023-01-30 05:30:00,23715.3,-6.4,504387.6500000004,404387.6500000004
2023-01-30 05:45:00,23733.7,2023-01-30 08:00:00,23670.1,-63.6,504324.0500000004,404324.0500000004
2023-01-30 08:15:00,23552.5,2023-01-30 14:30:00,23194.0,358.5,504682.5500000004,404682.5500000004
2023-01-30 14:45:00,23281.6,2023-01-30 18:45:00,23136.9,-144.7,504537.8500000004,404537.8500000004
2023-01-30 19:00:00,22792.0,2023-01-30 19:00:00,22792.0,-344.22,504193.6300000004,404193.6300000004
2023-01-30 23:15:00,22787.6,2023-01-31 05:30:00,22824.1,36.5,504230.1300000004,404230.1300000004
2023-01-31 05:45:00,22748.1,2023-01-31 07:15:00,22856.5,-108.4,504121.7300000004,404121.7300000004
2023-01-31 07:30:00,22901.2,2023-01-31 10:30:00,22854.8,-46.4,504075.33000000037,404075.33000000037
2023-01-31 10:45:00,22821.1,2023-01-31 13:15:00,22887.1,-66.0,504009.33000000037,404009.33000000037
2023-01-31 13:30:00,23065.5,2023-01-31 21:00:00,23064.3,-1.2,504008.13000000035,404008.13000000035
2023-01-31 21:15:00,22982.9,2023-01-31 22:30:00,22977.8,5.1,504013.23000000033,404013.23000000033
2023-01-31 22:45:00,23178.6,2023-02-01 00:00:00,23084.6,-94.0,503919.23000000033,403919.23000000033
2023-02-01 00:15:00,23034.9,2023-02-01 04:45:00,23130.0,-95.1,503824.13000000035,403824.13000000035
2023-02-01 05:00:00,23152.6,2023-02-01 08:00:00,23048.3,-104.3,503719.83000000037,403719.83000000037
2023-02-01 08:15:00,22962.3,2023-02-01 11:00:00,23016.5,-54.2,503665.63000000035,403665.63000000035
2023-02-01 11:15:00,23087.2,2023-02-01 15:30:00,23009.9,-77.3,503588.33000000037,403588.33000000037
2023-02-01 15:45:00,22975.7,2023-02-01 18:00:00,22964.9,10.8,503599.13000000035,403599.13000000035
2023-02-01 18:15:00,23103.9,2023-02-02 02:00:00,23945.8,841.9,504441.0300000004,404441.0300000004
2023-02-02 02:15:00,23916.0,2023-02-02 09:30:00,23807.6,108.4,504549.4300000004,404549.4300000004
2023-02-02 09:45:00,23839.7,2023-02-02 14:30:00,23768.3,-71.4,504478.0300000004,404478.0300000004
2023-02-02 14:45:00,23611.8,2023-02-02 15:30:00,23801.3,-189.5,504288.5300000004,404288.5300000004
2023-02-02 15:45:00,23843.3,2023-02-02 19:15:00,23835.5,-7.8,504280.7300000004,404280.7300000004
2023-02-02 19:30:00,23755.9,2023-02-03 05:45:00,23527.1,228.8,504509.5300000004,404509.5300000004
2023-02-03 06:00:00,23551.4,2023-02-03 08:00:00,23392.6,-171.8,504337.7300000004,404337.7300000004
2023-02-03 10:15:00,23380.1,2023-02-03 11:15:00,23467.5,-87.4,504250.33000000037,404250.33000000037
2023-02-03 11:30:00,23513.3,2023-02-03 13:30:00,23378.1,-200.55,504049.7800000004,404049.7800000004
2023-02-03 13:45:00,23348.9,2023-02-03 14:30:00,23480.6,-131.7,503918.08000000037,403918.08000000037
2023-02-03 14:45:00,23516.3,2023-02-03 18:00:00,23457.7,-58.6,503859.4800000004,403859.4800000004
2023-02-03 18:15:00,23423.7,2023-02-03 22:30:00,23414.2,9.5,503868.9800000004,403868.9800000004
2023-02-03 22:45:00,23417.2,2023-02-04 04:15:00,23344.9,-72.3,503796.6800000004,403796.6800000004
2023-02-04 04:30:00,23325.6,2023-02-04 10:15:00,23332.1,-6.5,503790.1800000004,403790.1800000004
2023-02-04 10:30:00,23355.0,2023-02-04 15:00:00,23466.9,111.9,503902.0800000004,403902.0800000004
2023-02-04 15:15:00,23416.4,2023-02-05 03:30:00,23314.8,101.6,504003.6800000004,404003.6800000004
2023-02-05 03:45:00,23343.4,2023-02-05 11:30:00,23369.2,25.8,504029.4800000004,404029.4800000004
2023-02-05 11:45:00,23354.1,2023-02-05 13:15:00,23146.9,207.2,504236.6800000004,404236.6800000004
2023-02-05 13:30:00,23189.5,2023-02-05 16:15:00,23137.4,-198.92,504037.7600000004,404037.7600000004
2023-02-05 17:30:00,22914.1,2023-02-05 21:45:00,22896.8,17.3,504055.0600000004,404055.0600000004
2023-02-05 22:00:00,22958.1,2023-02-06 02:30:00,22955.0,-3.1,504051.9600000004,404051.9600000004
2023-02-06 02:45:00,22874.5,2023-02-06 06:45:00,22776.1,98.4,504150.36000000045,404150.36000000045
2023-02-06 07:00:00,22795.0,2023-02-06 11:00:00,22790.0,-5.0,504145.36000000045,404145.36000000045
2023-02-06 11:15:00,22750.1,2023-02-06 12:00:00,22856.2,-177.8,503967.56000000046,403967.56000000046
2023-02-06 15:45:00,23040.5,2023-02-06 21:15:00,22973.7,-66.8,503900.7600000005,403900.7600000005
2023-02-06 21:30:00,22969.9,2023-02-07 00:45:00,22789.5,180.4,504081.1600000005,404081.1600000005
2023-02-07 01:00:00,22839.1,2023-02-07 15:00:00,22940.7,101.6,504182.7600000005,404182.7600000005
2023-02-07 15:15:00,22896.5,2023-02-07 17:30:00,22997.3,-100.8,504081.9600000005,404081.9600000005
2023-02-07 17:45:00,23278.0,2023-02-07 17:45:00,23278.0,-259.82,503822.1400000005,403822.1400000005
2023-02-07 18:15:00,22786.3,2023-02-07 18:15:00,22786.3,-351.59,503470.55000000045,403470.55000000045
2023-02-07 20:15:00,23190.9,2023-02-08 02:45:00,23240.0,49.1,503519.65000000043,403519.65000000043
2023-02-08 03:00:00,23232.5,2023-02-08 16:30:00,22855.3,377.2,503896.85000000044,403896.85000000044
2023-02-08 16:45:00,22957.8,2023-02-09 02:30:00,22877.3,-80.5,503816.35000000044,403816.35000000044
2023-02-09 02:45:00,22794.9,2023-02-09 05:15:00,22571.2,223.7,504040.05000000045,404040.05000000045
2023-02-09 05:30:00,22598.7,2023-02-09 15:00:00,22671.4,72.7,504112.75000000047,404112.75000000047
2023-02-09 15:15:00,22615.4,2023-02-10 02:15:00,21874.13,741.27,504854.0200000005,404854.0200000005
2023-02-10 06:15:00,21841.6,2023-02-10 11:30:00,21773.0,-68.6,504785.4200000005,404785.4200000005
2023-02-10 11:45:00,21726.6,2023-02-10 14:45:00,21835.9,-109.3,504676.1200000005,404676.1200000005
2023-02-10 15:00:00,21869.6,2023-02-10 15:30:00,21716.9,-152.7,504523.4200000005,404523.4200000005
2023-02-10 15:45:00,21649.0,2023-02-10 18:30:00,21682.1,-33.1,504490.32000000053,404490.32000000053
2023-02-10 18:45:00,21696.2,2023-02-10 21:15:00,21623.7,-72.5,504417.82000000053,404417.82000000053
2023-02-10 21:30:00,21507.7,2023-02-11 00:00:00,21595.1,-87.4,504330.4200000005,404330.4200000005
2023-02-11 00:15:00,21628.1,2023-02-11 16:15:00,21717.1,89.0,504419.4200000005,404419.4200000005
2023-02-11 16:30:00,21685.9,2023-02-11 20:00:00,21645.2,40.7,504460.1200000005,404460.1200000005
2023-02-11 20:15:00,21696.6,2023-02-12 01:45:00,21797.4,100.8,504560.9200000005,404560.9200000005
2023-02-12 02:00:00,21772.4,2023-02-12 08:15:00,21801.4,-29.0,504531.9200000005,404531.9200000005
2023-02-12 08:30:00,21836.8,2023-02-12 09:45:00,21896.4,59.6,504591.5200000005,404591.5200000005
2023-02-12 10:00:00,21840.0,2023-02-12 14:15:00,21826.0,14.0,504605.5200000005,404605.5200000005
2023-02-12 14:30:00,21936.7,2023-02-12 20:45:00,21955.0,18.3,504623.8200000005,404623.8200000005
2023-02-12 21:00:00,21927.6,2023-02-13 03:30:00,21802.0,125.6,504749.42000000045,404749.42000000045
2023-02-13 03:45:00,21800.9,2023-02-13 08:15:00,21769.8,-31.1,504718.3200000005,404718.3200000005
2023-02-13 08:30:00,21698.4,2023-02-13 11:00:00,21582.5,115.9,504834.2200000005,404834.2200000005
2023-02-13 11:15:00,21626.9,2023-02-13 16:30:00,21511.6,-237.65,504596.5700000005,404596.5700000005
2023-02-13 17:30:00,21445.4,2023-02-13 18:15:00,21578.0,-132.6,504463.9700000005,404463.9700000005
2023-02-13 18:30:00,21593.2,2023-02-14 03:00:00,21727.9,134.7,504598.6700000005,404598.6700000005
2023-02-14 03:15:00,21690.8,2023-02-14 09:30:00,21717.5,-26.7,504571.9700000005,404571.9700000005
2023-02-14 09:45:00,21808.7,2023-02-14 13:30:00,21701.4,-203.3,504368.6700000005,404368.6700000005
2023-02-14 14:00:00,21636.7,2023-02-14 14:30:00,21709.8,-73.1,504295.57000000053,404295.57000000053
2023-02-14 14:45:00,22239.9,2023-02-14 14:45:00,22239.9,-347.99,503947.58000000054,403947.58000000054
2023-02-15 00:30:00,22122.9,2023-02-15 07:00:00,22128.0,-5.1,503942.48000000056,403942.48000000056
2023-02-15 07:15:00,22146.0,2023-02-15 13:45:00,22687.1,541.1,504483.58000000054,404483.58000000054
2023-02-15 14:00:00,22666.0,2023-02-15 18:15:00,22860.4,-194.4,504289.1800000005,404289.1800000005
2023-02-15 18:30:00,22935.6,2023-02-15 23:30:00,24293.22,1357.62,505646.8000000005,405646.8000000005
2023-02-16 05:00:00,24632.4,2023-02-16 09:30:00,24630.6,1.8,505648.6000000005,405648.6000000005
2023-02-16 09:45:00,24662.8,2023-02-16 13:45:00,24465.0,-256.54,505392.0600000005,405392.0600000005
2023-02-16 14:15:00,24412.4,2023-02-16 15:15:00,24557.9,-145.5,505246.5600000005,405246.5600000005
2023-02-16 15:30:00,24792.3,2023-02-16 19:30:00,24887.4,95.1,505341.6600000005,405341.6600000005
2023-02-16 19:45:00,24879.0,2023-02-17 01:30:00,23757.2,1121.8,506463.4600000005,406463.4600000005
2023-02-17 01:45:00,23852.2,2023-02-17 07:30:00,23747.9,-104.3,506359.1600000005,406359.1600000005
2023-02-17 07:45:00,23636.0,2023-02-17 11:00:00,23745.9,-109.9,506249.2600000005,406249.2600000005
2023-02-17 11:15:00,23829.1,2023-02-17 21:30:00,24692.8,863.7,507112.9600000005,407112.9600000005
2023-02-17 21:45:00,24485.1,2023-02-17 22:30:00,24579.5,-94.4,507018.56000000046,407018.56000000046
2023-02-17 22:45:00,24683.3,2023-02-18 06:45:00,24630.0,-53.3,506965.2600000005,406965.2600000005
2023-02-18 07:00:00,24576.1,2023-02-18 12:30:00,24586.3,-10.2,506955.06000000046,406955.06000000046
2023-02-18 12:45:00,24624.5,2023-02-18 19:15:00,24688.3,63.8,507018.86000000045,407018.86000000045
2023-02-18 19:30:00,24596.0,2023-02-19 00:00:00,24647.6,-51.6,506967.2600000005,406967.2600000005
2023-02-19 00:15:00,24734.7,2023-02-19 06:00:00,24757.0,22.3,506989.56000000046,406989.56000000046
2023-02-19 06:15:00,24687.2,2023-02-19 12:30:00,24683.3,3.9,506993.4600000005,406993.4600000005
2023-02-19 12:45:00,24700.5,2023-02-19 16:30:00,24931.1,230.6,507224.06000000046,407224.06000000046
2023-02-19 16:45:00,24781.1,2023-02-20 01:45:00,24231.0,550.1,507774.16000000044,407774.16000000044
2023-02-20 02:00:00,24332.5,2023-02-20 19:45:00,24878.5,546.0,508320.16000000044,408320.16000000044
2023-02-20 20:00:00,24817.7,2023-02-21 00:15:00,24819.0,-1.3,508318.86000000045,408318.86000000045
2023-02-21 00:30:00,24915.3,2023-02-21 08:15:00,25055.5,140.2,508459.06000000046,408459.06000000046
2023-02-21 08:30:00,24812.0,2023-02-21 17:30:00,24474.1,337.9,508796.9600000005,408796.9600000005
2023-02-21 17:45:00,24656.3,2023-02-21 20:45:00,24468.1,-188.2,508608.7600000005,408608.7600000005
2023-02-21 21:00:00,24380.3,2023-02-22 03:45:00,24198.8,181.5,508790.2600000005,408790.2600000005
2023-02-22 04:00:00,24203.9,2023-02-22 08:15:00,23997.6,-206.3,508583.9600000005,408583.9600000005
2023-02-22 08:30:00,23870.7,2023-02-22 10:15:00,24094.6,-223.9,508360.06000000046,408360.06000000046
2023-02-22 10:30:00,24163.3,2023-02-22 14:45:00,23927.7,-235.6,508124.4600000005,408124.4600000005
2023-02-22 15:00:00,23805.4,2023-02-22 22:00:00,23826.0,-20.6,508103.8600000005,408103.8600000005
2023-02-22 22:15:00,23967.8,2023-02-23 06:00:00,24376.9,409.1,508512.9600000005,408512.9600000005
2023-02-23 06:15:00,24357.9,2023-02-23 12:45:00,23900.5,457.4,508970.3600000005,408970.3600000005
2023-02-23 13:00:00,24092.8,2023-02-23 16:30:00,23871.4,-221.4,508748.9600000005,408748.9600000005
2023-02-23 16:45:00,23749.2,2023-02-24 00:45:00,23946.2,-197.0,508551.9600000005,408551.9600000005
2023-02-24 01:00:00,24079.5,2023-02-24 04:30:00,23961.6,-117.9,508434.06000000046,408434.06000000046
2023-02-24 04:45:00,23928.5,2023-02-24 11:45:00,23876.4,52.1,508486.16000000044,408486.16000000044
2023-02-24 12:00:00,23928.1,2023-02-24 13:15:00,23886.6,-41.5,508444.66000000044,408444.66000000044
2023-02-24 13:30:00,23761.9,2023-02-24 20:00:00,23176.9,585.0,509029.66000000044,409029.66000000044
2023-02-24 20:15:00,23259.7,2023-02-25 02:00:00,23162.0,-97.7,508931.9600000004,408931.9600000004
2023-02-25 02:15:00,23113.8,2023-02-25 13:15:00,23019.0,94.8,509026.7600000004,409026.7600000004
2023-02-25 13:30:00,23027.1,2023-02-25 20:00:00,22959.1,-68.0,508958.7600000004,408958.7600000004
2023-02-25 20:15:00,22906.0,2023-02-25 21:00:00,22899.0,7.0,508965.7600000004,408965.7600000004
2023-02-25 21:15:00,22921.8,2023-02-26 05:45:00,23114.0,192.2,509157.9600000004,409157.9600000004
2023-02-26 06:00:00,23082.2,2023-02-26 09:00:00,23178.6,-96.4,509061.5600000004,409061.5600000004
2023-02-26 09:15:00,23220.2,2023-02-26 16:45:00,23175.6,-44.6,509016.9600000004,409016.9600000004
2023-02-26 17:00:00,23171.9,2023-02-26 18:15:00,23213.4,-41.5,508975.4600000004,408975.4600000004
2023-02-26 18:30:00,23427.8,2023-02-26 18:30:00,23427.8,-199.92,508775.54000000044,408775.54000000044
2023-02-26 22:15:00,23363.6,2023-02-27 01:30:00,23508.6,-145.0,508630.54000000044,408630.54000000044
2023-02-27 01:45:00,23544.0,2023-02-27 04:45:00,23480.2,-63.8,508566.74000000046,408566.74000000046
2023-02-27 05:00:00,23449.9,2023-02-27 13:00:00,23422.1,27.8,508594.54000000044,408594.54000000044
2023-02-27 13:15:00,23548.3,2023-02-27 15:15:00,23802.8,254.5,508849.04000000044,408849.04000000044
2023-02-27 15:30:00,23564.7,2023-02-27 21:45:00,23371.5,193.2,509042.24000000046,409042.24000000046
2023-02-27 22:00:00,23378.3,2023-02-28 05:15:00,23416.2,37.9,509080.1400000005,409080.1400000005
2023-02-28 05:30:00,23385.0,2023-02-28 10:30:00,23343.3,41.7,509121.8400000005,409121.8400000005
2023-02-28 10:45:00,23351.0,2023-02-28 19:00:00,23449.2,98.2,509220.0400000005,409220.0400000005
2023-02-28 19:15:00,23217.6,2023-03-01 02:15:00,23233.7,-16.1,509203.9400000005,409203.9400000005
2023-03-01 02:30:00,23280.3,2023-03-01 09:30:00,23750.6,470.3,509674.2400000005,409674.2400000005
2023-03-01 09:45:00,23749.3,2023-03-01 21:30:00,23523.1,226.2,509900.4400000005,409900.4400000005
2023-03-01 21:45:00,23544.9,2023-03-02 01:00:00,23620.3,75.4,509975.84000000055,409975.84000000055
2023-03-02 01:15:00,23547.1,2023-03-02 18:30:00,23379.3,167.8,510143.64000000054,410143.64000000054
2023-03-02 18:45:00,23435.1,2023-03-03 01:00:00,23403.6,-31.5,510112.14000000054,410112.14000000054
2023-03-03 01:15:00,22835.5,2023-03-03 01:15:00,22835.5,-292.72,509819.42000000057,409819.42000000057
2023-03-03 03:15:00,22370.7,2023-03-03 12:15:00,22340.9,-29.8,509789.6200000006,409789.6200000006
2023-03-03 12:30:00,22322.4,2023-03-03 13:45:00,22391.4,-69.0,509720.6200000006,409720.6200000006
2023-03-03 14:00:00,22392.3,2023-03-03 18:30:00,22324.7,-67.6,509653.0200000006,409653.0200000006
2023-03-03 18:45:00,22303.5,2023-03-03 22:45:00,22308.9,-5.4,509647.6200000006,409647.6200000006
2023-03-03 23:00:00,22336.9,2023-03-04 10:00:00,22336.6,-0.3,509647.3200000006,409647.3200000006
2023-03-04 10:15:00,22332.5,2023-03-04 18:00:00,22307.3,25.2,509672.5200000006,409672.5200000006
2023-03-04 18:15:00,22310.8,2023-03-04 19:30:00,22273.7,-37.1,509635.4200000006,409635.4200000006
2023-03-04 19:45:00,22238.7,2023-03-04 22:00:00,22213.0,25.7,509661.12000000064,409661.12000000064
2023-03-04 22:15:00,22302.2,2023-03-05 02:15:00,22528.5,226.3,509887.4200000006,409887.4200000006
2023-03-05 02:30:00,22324.6,2023-03-05 03:45:00,22374.2,-49.6,509837.82000000065,409837.82000000065
2023-03-05 04:00:00,22439.0,2023-03-05 08:30:00,22345.3,-93.7,509744.12000000064,409744.12000000064
2023-03-05 08:45:00,22331.2,2023-03-05 12:30:00,22397.7,-66.5,509677.62000000064,409677.62000000064
2023-03-05 12:45:00,22410.1,2023-03-05 19:00:00,22423.9,13.8,509691.4200000006,409691.4200000006
2023-03-05 19:15:00,22380.0,2023-03-05 20:45:00,22397.6,-17.6,509673.82000000065,409673.82000000065
2023-03-05 21:00:00,22490.2,2023-03-05 21:00:00,22490.2,-96.04,509577.78000000067,409577.78000000067
2023-03-05 21:30:00,22354.3,2023-03-06 05:45:00,22358.6,-4.3,509573.4800000007,409573.4800000007
2023-03-06 06:00:00,22371.8,2023-03-06 19:00:00,22487.9,116.1,509689.58000000066,409689.58000000066
2023-03-06 19:15:00,22394.9,2023-03-07 00:45:00,22402.7,-7.8,509681.78000000067,409681.78000000067
2023-03-07 01:00:00,22479.8,2023-03-07 05:00:00,22460.0,-19.8,509661.9800000007,409661.9800000007
2023-03-07 05:15:00,22453.6,2023-03-07 15:00:00,22023.7,429.9,510091.8800000007,410091.8800000007
2023-03-07 15:15:00,22201.1,2023-03-07 18:15:00,22258.0,56.9,510148.7800000007,410148.7800000007
2023-03-07 18:30:00,22199.0,2023-03-07 23:15:00,22133.1,65.9,510214.68000000075,410214.68000000075
2023-03-07 23:30:00,22181.8,2023-03-08 04:00:00,22149.7,-32.1,510182.5800000008,410182.5800000008
2023-03-08 04:15:00,22115.9,2023-03-08 06:30:00,21988.8,127.1,510309.68000000075,410309.68000000075
2023-03-08 06:45:00,22015.1,2023-03-08 12:45:00,22007.1,-8.0,510301.68000000075,410301.68000000075
2023-03-08 13:00:00,21982.4,2023-03-08 15:00:00,22136.9,-226.58,510075.10000000073,410075.10000000073
2023-03-08 15:30:00,22136.9,2023-03-08 18:00:00,22026.1,-110.8,509964.30000000075,409964.30000000075
2023-03-08 18:15:00,21961.0,2023-03-09 02:00:00,21711.0,250.0,510214.30000000075,410214.30000000075
2023-03-09 02:15:00,21778.4,2023-03-09 07:45:00,21680.9,-118.14,510096.16000000073,410096.16000000073
2023-03-09 08:00:00,21647.0,2023-03-09 11:30:00,21653.6,-6.6,510089.56000000075,410089.56000000075
2023-03-09 11:45:00,21664.4,2023-03-09 16:00:00,21639.8,-24.6,510064.9600000008,410064.9600000008
2023-03-09 16:15:00,21597.8,2023-03-09 20:45:00,20071.48,1526.32,511591.2800000008,411591.2800000008
2023-03-10 12:15:00,19859.6,2023-03-10 14:15:00,20020.0,160.4,511751.6800000008,411751.6800000008
2023-03-10 14:30:00,19718.8,2023-03-10 16:00:00,19953.4,-234.6,511517.08000000083,411517.08000000083
2023-03-10 16:15:00,20132.9,2023-03-10 18:30:00,19904.2,-228.7,511288.3800000008,411288.3800000008
2023-03-10 18:45:00,19838.5,2023-03-10 23:00:00,20150.1,-338.84,510949.5400000008,410949.5400000008
2023-03-10 23:30:00,20196.6,2023-03-11 03:45:00,20381.2,184.6,511134.14000000077,411134.14000000077
2023-03-11 04:00:00,20286.2,2023-03-11 08:15:00,19947.2,339.0,511473.14000000077,411473.14000000077
2023-03-11 08:30:00,20199.2,2023-03-12 05:30:00,20376.7,177.5,511650.64000000077,411650.64000000077
2023-03-12 05:45:00,20343.5,2023-03-12 10:15:00,20395.5,-52.0,511598.64000000077,411598.64000000077
2023-03-12 10:30:00,20419.9,2023-03-12 14:30:00,20375.4,-44.5,511554.14000000077,411554.14000000077
2023-03-12 14:45:00,20331.4,2023-03-12 17:00:00,20386.5,-55.1,511499.0400000008,411499.0400000008
2023-03-12 17:15:00,20629.8,2023-03-12 17:15:00,20629.8,-236.98,511262.0600000008,411262.0600000008
2023-03-12 19:15:00,20842.3,2023-03-12 20:30:00,21201.1,-358.8,510903.2600000008,410903.2600000008
2023-03-12 20:45:00,21249.0,2023-03-13 06:00:00,22469.33,1220.33,512123.59000000084,412123.59000000084
2023-03-13 08:45:00,22185.3,2023-03-13 12:45:00,22123.0,62.3,512185.8900000008,412185.8900000008
2023-03-13 13:00:00,22321.8,2023-03-13 20:30:00,24246.77,1924.97,514110.8600000008,414110.8600000008
2023-03-14 00:00:00,24016.9,2023-03-14 02:00:00,24322.7,-467.92,513642.9400000008,413642.9400000008
2023-03-14 03:30:00,24390.6,2023-03-14 05:15:00,24363.9,-26.7,513616.2400000008,413616.2400000008
2023-03-14 05:30:00,24301.3,2023-03-14 10:30:00,24390.0,-88.7,513527.5400000008,413527.5400000008
2023-03-14 10:45:00,24571.5,2023-03-14 17:00:00,25863.0,1291.5,514819.0400000008,414819.0400000008
2023-03-14 17:15:00,25759.7,2023-03-15 00:30:00,24513.9,1245.8,516064.8400000008,416064.8400000008
2023-03-15 00:45:00,24742.6,2023-03-15 08:45:00,24768.8,26.2,516091.0400000008,416091.0400000008
2023-03-15 09:00:00,24750.9,2023-03-15 12:45:00,24831.9,-81.0,516010.0400000008,416010.0400000008
2023-03-15 13:00:00,25061.7,2023-03-15 15:45:00,24480.1,-581.6,515428.4400000008,415428.4400000008
2023-03-15 16:00:00,24239.9,2023-03-15 21:30:00,24446.8,-206.9,515221.5400000008,415221.5400000008
2023-03-15 21:45:00,24426.9,2023-03-16 02:45:00,24365.6,-61.3,515160.2400000008,415160.2400000008
2023-03-16 03:00:00,24257.4,2023-03-16 06:30:00,24442.4,-185.0,514975.2400000008,414975.2400000008
2023-03-16 06:45:00,24569.3,2023-03-16 20:30:00,24904.8,335.5,515310.7400000008,415310.7400000008
2023-03-16 20:45:00,24680.6,2023-03-16 21:15:00,24830.0,-149.4,515161.3400000008,415161.3400000008
2023-03-16 21:30:00,25067.9,2023-03-17 10:15:00,26580.35,1512.45,516673.7900000008,416673.7900000008
2023-03-17 14:15:00,26392.3,2023-03-17 18:45:00,26605.8,-213.5,516460.2900000008,416460.2900000008
2023-03-17 19:00:00,26762.4,2023-03-18 03:45:00,27293.3,530.9,516991.1900000008,416991.1900000008
2023-03-18 04:00:00,27219.3,2023-03-18 10:30:00,27392.0,-172.7,516818.4900000008,416818.4900000008
2023-03-18 10:45:00,27456.3,2023-03-18 15:15:00,27295.5,-160.8,516657.6900000008,416657.6900000008
2023-03-18 15:30:00,27123.0,2023-03-18 16:30:00,27278.2,-155.2,516502.4900000008,416502.4900000008
2023-03-18 16:45:00,27343.0,2023-03-18 22:15:00,27158.9,-184.1,516318.3900000008,416318.3900000008
2023-03-18 22:30:00,26930.0,2023-03-19 03:15:00,27092.7,-162.7,516155.6900000008,416155.6900000008
2023-03-19 03:30:00,27115.9,2023-03-19 06:00:00,27029.5,-86.4,516069.2900000008,416069.2900000008
2023-03-19 06:15:00,26971.2,2023-03-19 11:30:00,27057.5,-86.3,515982.9900000008,415982.9900000008
2023-03-19 11:45:00,27152.2,2023-03-20 00:30:00,27891.4,739.2,516722.1900000008,416722.1900000008
2023-03-20 00:45:00,27815.0,2023-03-20 06:30:00,27459.1,355.9,517078.09000000084,417078.09000000084
2023-03-20 06:45:00,27617.1,2023-03-20 13:15:00,28072.0,454.9,517532.99000000086,417532.99000000086
2023-03-20 13:30:00,27846.9,2023-03-20 20:30:00,27894.6,-47.7,517485.29000000085,417485.29000000085
2023-03-20 20:45:00,27988.8,2023-03-20 23:15:00,27802.3,-186.5,517298.79000000085,417298.79000000085
2023-03-20 23:30:00,27619.3,2023-03-21 04:00:00,27848.0,-228.7,517070.09000000084,417070.09000000084
2023-03-21 04:15:00,27900.6,2023-03-21 06:30:00,27695.5,-205.1,516864.99000000086,416864.99000000086
2023-03-21 06:45:00,27621.3,2023-03-21 08:45:00,27633.2,-11.9,516853.09000000084,416853.09000000084
2023-03-21 09:00:00,27660.8,2023-03-21 20:45:00,28058.0,397.2,517250.29000000085,417250.29000000085
2023-03-21 21:00:00,27967.6,2023-03-22 03:00:00,28174.7,-207.1,517043.1900000009,417043.1900000009
2023-03-22 03:15:00,28191.9,2023-03-22 18:30:00,28197.6,5.7,517048.8900000009,417048.8900000009
2023-03-22 18:45:00,28017.8,2023-03-22 23:45:00,27233.8,784.0,517832.8900000009,417832.8900000009
2023-03-23 00:00:00,27280.6,2023-03-23 10:45:00,27597.3,316.7,518149.5900000009,418149.5900000009
2023-03-23 11:00:00,27486.4,2023-03-23 14:30:00,27396.2,90.2,518239.7900000009,418239.7900000009
2023-03-23 14:45:00,28043.6,2023-03-23 14:45:00,28043.6,-462.71,517777.0800000009,417777.0800000009
2023-03-23 18:30:00,28103.2,2023-03-23 22:45:00,28205.8,-102.6,517674.4800000009,417674.4800000009
2023-03-23 23:00:00,28328.0,2023-03-24 04:15:00,28180.1,-147.9,517526.5800000009,417526.5800000009
2023-03-24 04:30:00,28159.1,2023-03-24 12:00:00,27781.4,377.7,517904.2800000009,417904.2800000009
2023-03-24 12:15:00,27978.5,2023-03-24 17:00:00,27786.3,-192.2,517712.0800000009,417712.0800000009
2023-03-24 17:15:00,27672.6,2023-03-24 23:30:00,27404.4,268.2,517980.2800000009,417980.2800000009
2023-03-24 23:45:00,27438.9,2023-03-25 08:15:00,27425.1,-13.8,517966.4800000009,417966.4800000009
2023-03-25 08:30:00,27385.1,2023-03-25 14:00:00,27559.4,-174.3,517792.1800000009,417792.1800000009
2023-03-25 14:15:00,27585.0,2023-03-25 17:00:00,27629.9,44.9,517837.08000000095,417837.08000000095
2023-03-25 17:15:00,27452.6,2023-03-25 21:45:00,27394.1,58.5,517895.58000000095,417895.58000000095
2023-03-25 22:00:00,27499.9,2023-03-26 14:15:00,27933.1,433.2,518328.78000000096,418328.78000000096
2023-03-26 14:30:00,27797.3,2023-03-26 19:45:00,27814.1,-16.8,518311.980000001,418311.980000001
2023-03-26 20:00:00,27864.2,2023-03-27 01:30:00,27865.9,1.7,518313.680000001,418313.680000001
2023-03-27 01:45:00,27813.8,2023-03-27 09:00:00,27809.7,4.1,518317.78000000096,418317.78000000096
2023-03-27 09:15:00,27896.4,2023-03-27 12:30:00,27766.1,-130.3,518187.480000001,418187.480000001
2023-03-27 12:45:00,27738.0,2023-03-27 15:45:00,26887.3,850.7,519038.180000001,419038.180000001
2023-03-27 16:00:00,27144.7,2023-03-28 00:30:00,27046.6,-98.1,518940.080000001,418940.080000001
2023-03-28 00:45:00,26952.6,2023-03-28 05:45:00,26962.8,-10.2,518929.880000001,418929.880000001
2023-03-28 06:00:00,27056.9,2023-03-28 09:30:00,26934.7,-122.2,518807.680000001,418807.680000001
2023-03-28 09:45:00,26865.1,2023-03-28 11:30:00,26892.0,-26.9,518780.78000000096,418780.78000000096
2023-03-28 11:45:00,27046.7,2023-03-28 16:30:00,26901.3,-145.4,518635.38000000094,418635.38000000094
2023-03-28 16:45:00,26874.5,2023-03-28 18:30:00,27023.7,-149.2,518486.1800000009,418486.1800000009
2023-03-28 18:45:00,27333.0,2023-03-28 22:15:00,27199.6,-133.4,518352.7800000009,418352.7800000009
2023-03-28 22:30:00,27162.2,2023-03-29 01:15:00,27386.7,-280.88,518071.9000000009,418071.9000000009
2023-03-29 04:00:00,27360.9,2023-03-29 13:00:00,28468.43,1107.53,519179.4300000009,419179.4300000009
2023-03-29 16:30:00,28293.5,2023-03-29 20:00:00,28370.0,-76.5,519102.9300000009,419102.9300000009
2023-03-29 20:15:00,28427.8,2023-03-30 02:45:00,28952.0,524.2,519627.13000000094,419627.13000000094
2023-03-30 03:00:00,28374.5,2023-03-30 05:15:00,28478.3,-103.8,519523.33000000095,419523.33000000095
2023-03-30 05:30:00,28580.8,2023-03-30 13:45:00,28505.0,-75.8,519447.53000000096,419447.53000000096
2023-03-30 14:00:00,28249.7,2023-03-30 20:15:00,27968.9,280.8,519728.33000000095,419728.33000000095
2023-03-30 20:30:00,28084.1,2023-03-31 05:30:00,28137.3,53.2,519781.53000000096,419781.53000000096
2023-03-31 05:45:00,28025.4,2023-03-31 09:45:00,27805.0,220.4,520001.930000001,420001.930000001
2023-03-31 10:00:00,27824.9,2023-03-31 17:15:00,28376.1,551.2,520553.130000001,420553.130000001
2023-03-31 17:30:00,28273.8,2023-03-31 21:45:00,28468.3,-303.89,520249.240000001,420249.240000001
2023-03-31 22:45:00,28560.5,2023-04-01 02:15:00,28599.0,38.5,520287.740000001,420287.740000001
2023-04-01 02:30:00,28499.6,2023-04-01 15:30:00,28355.0,144.6,520432.34000000096,420432.34000000096
2023-04-01 15:45:00,28387.2,2023-04-02 00:15:00,28449.1,61.9,520494.240000001,420494.240000001
2023-04-02 00:30:00,28410.2,2023-04-02 17:15:00,28094.9,315.3,520809.54000000097,420809.54000000097
2023-04-02 17:30:00,28175.3,2023-04-02 19:15:00,28107.4,-67.9,520741.64000000095,420741.64000000095
2023-04-02 19:30:00,27935.9,2023-04-02 20:45:00,28042.2,-106.3,520635.34000000096,420635.34000000096
2023-04-02 21:00:00,28111.0,2023-04-02 22:15:00,27943.5,-278.2,520357.14000000095,420357.14000000095
2023-04-03 01:30:00,27701.9,2023-04-03 01:30:00,27701.9,-332.34,520024.8000000009,420024.8000000009
2023-04-03 07:15:00,27905.1,2023-04-03 11:45:00,28243.4,338.3,520363.1000000009,420363.1000000009
2023-04-03 12:00:00,28218.2,2023-04-03 21:30:00,27555.0,663.2,521026.3000000009,421026.3000000009
2023-04-03 21:45:00,27699.0,2023-04-04 14:45:00,28111.5,412.5,521438.8000000009,421438.8000000009
2023-04-04 15:00:00,28069.9,2023-04-04 20:15:00,28165.7,-95.8,521343.00000000093,421343.00000000093
2023-04-04 20:30:00,28237.9,2023-04-05 03:00:00,28472.6,234.7,521577.70000000094,421577.70000000094
2023-04-05 03:15:00,28444.4,2023-04-05 12:15:00,28524.4,-187.42,521390.28000000096,421390.28000000096
2023-04-05 19:15:00,28189.2,2023-04-06 00:15:00,28102.8,-86.4,521303.88000000094,421303.88000000094
2023-04-06 00:30:00,27981.3,2023-04-06 03:30:00,28064.4,-83.1,521220.78000000096,421220.78000000096
2023-04-06 03:45:00,28117.4,2023-04-06 07:30:00,27980.9,-136.5,521084.28000000096,421084.28000000096
2023-04-06 07:45:00,27896.8,2023-04-06 11:15:00,27889.7,7.1,521091.38000000094,421091.38000000094
2023-04-06 11:30:00,27920.9,2023-04-06 20:30:00,28063.0,142.1,521233.4800000009,421233.4800000009
2023-04-06 20:45:00,27965.1,2023-04-07 00:30:00,28038.2,-73.1,521160.38000000094,421160.38000000094
2023-04-07 00:45:00,28086.1,2023-04-07 02:30:00,27976.0,-160.94,520999.44000000093,420999.44000000093
2023-04-07 06:00:00,27932.1,2023-04-07 17:00:00,27886.4,45.7,521045.14000000095,421045.14000000095
2023-04-07 17:15:00,27907.1,2023-04-08 08:30:00,28077.3,170.2,521215.34000000096,421215.34000000096
2023-04-08 08:45:00,28012.1,2023-04-08 14:00:00,28006.6,5.5,521220.84000000096,421220.84000000096
2023-04-08 14:15:00,28036.6,2023-04-08 17:30:00,27968.3,-68.3,521152.54000000097,421152.54000000097
2023-04-08 17:45:00,27926.1,2023-04-09 00:00:00,27942.9,-16.8,521135.740000001,421135.740000001
2023-04-09 00:15:00,27995.4,2023-04-09 05:30:00,28027.9,32.5,521168.240000001,421168.240000001
2023-04-09 05:45:00,27987.8,2023-04-09 11:15:00,27854.3,133.5,521301.740000001,421301.740000001
2023-04-09 11:30:00,27911.1,2023-04-09 14:00:00,27905.9,-5.2,521296.54000000097,421296.54000000097
2023-04-09 14:15:00,27831.5,2023-04-09 16:15:00,27894.5,-63.0,521233.54000000097,421233.54000000097
2023-04-09 16:30:00,27907.5,2023-04-09 20:30:00,28108.7,201.2,521434.740000001,421434.740000001
2023-04-09 20:45:00,28105.0,2023-04-09 21:15:00,28304.8,-219.85,521214.890000001,421214.890000001
2023-04-09 21:45:00,28423.2,2023-04-10 01:00:00,28316.5,-106.7,521108.190000001,421108.190000001
2023-04-10 01:15:00,28245.1,2023-04-10 07:45:00,28278.2,-33.1,521075.090000001,421075.090000001
2023-04-10 08:00:00,28329.9,2023-04-10 12:00:00,28270.0,-59.9,521015.190000001,421015.190000001
2023-04-10 12:15:00,28260.7,2023-04-10 14:45:00,28291.2,-30.5,520984.690000001,420984.690000001
2023-04-10 15:00:00,28434.4,2023-04-10 22:00:00,29726.42,1292.02,522276.710000001,422276.710000001
2023-04-11 05:15:00,30060.2,2023-04-11 07:15:00,30085.8,-25.6,522251.11000000103,422251.11000000103
2023-04-11 07:30:00,30118.3,2023-04-11 19:15:00,30404.9,286.6,522537.710000001,422537.710000001
2023-04-11 19:30:00,30171.9,2023-04-11 22:15:00,30165.3,6.6,522544.310000001,422544.310000001
2023-04-11 22:30:00,30190.3,2023-04-12 01:45:00,30157.2,-33.1,522511.210000001,422511.210000001
2023-04-12 02:00:00,30036.1,2023-04-12 10:00:00,29975.7,60.4,522571.61000000103,422571.61000000103
2023-04-12 10:15:00,30011.2,2023-04-12 12:30:00,30282.5,271.3,522842.910000001,422842.910000001
2023-04-12 12:45:00,30132.7,2023-04-12 17:00:00,29979.9,152.8,522995.710000001,422995.710000001
2023-04-12 17:15:00,29993.7,2023-04-13 04:15:00,30077.4,83.7,523079.410000001,423079.410000001
2023-04-13 04:30:00,30045.9,2023-04-13 08:45:00,30179.0,-213.8,522865.61000000103,422865.61000000103
2023-04-13 09:00:00,30284.2,2023-04-13 11:30:00,30183.0,-101.2,522764.410000001,422764.410000001
2023-04-13 11:45:00,30149.2,2023-04-13 14:15:00,30290.0,-140.8,522623.61000000103,422623.61000000103
2023-04-13 14:30:00,30375.0,2023-04-13 16:15:00,30344.0,-31.0,522592.61000000103,422592.61000000103
2023-04-13 16:30:00,30301.2,2023-04-14 00:00:00,30347.1,-45.9,522546.710000001,422546.710000001
2023-04-14 00:15:00,30386.7,2023-04-14 02:30:00,30653.9,267.2,522813.910000001,422813.910000001
2023-04-14 02:45:00,30595.0,2023-04-14 05:15:00,30745.1,-150.1,522663.81000000105,422663.81000000105
2023-04-14 05:30:00,30811.9,2023-04-14 07:30:00,30786.7,-25.2,522638.61000000103,422638.61000000103
2023-04-14 07:45:00,30739.9,2023-04-14 17:45:00,30260.5,479.4,523118.01000000106,423118.01000000106
2023-04-14 18:00:00,30331.2,2023-04-15 00:45:00,30361.1,29.9,523147.9100000011,423147.9100000011
2023-04-15 01:00:00,30342.3,2023-04-15 07:00:00,30394.9,-52.6,523095.3100000011,423095.3100000011
2023-04-15 07:15:00,30420.4,2023-04-15 13:30:00,30344.9,-75.5,523019.8100000011,423019.8100000011
2023-04-15 13:45:00,30320.3,2023-04-15 22:15:00,30328.1,-7.8,523012.0100000011,423012.0100000011
2023-04-15 22:30:00,30340.6,2023-04-16 00:45:00,30270.2,-70.4,522941.6100000011,422941.6100000011
2023-04-16 01:00:00,30169.0,2023-04-16 02:15:00,30253.4,-84.4,522857.21000000107,422857.21000000107
2023-04-16 02:30:00,30262.3,2023-04-16 08:45:00,30322.7,60.4,522917.6100000011,422917.6100000011
2023-04-16 09:00:00,30300.8,2023-04-16 14:15:00,30267.2,33.6,522951.21000000107,422951.21000000107
2023-04-16 14:30:00,30286.5,2023-04-16 19:30:00,30466.6,180.1,523131.31000000105,423131.31000000105
2023-04-16 19:45:00,30306.0,2023-04-17 02:15:00,29968.5,337.5,523468.81000000105,423468.81000000105
2023-04-17 02:30:00,30050.1,2023-04-17 06:15:00,29941.7,-108.4,523360.410000001,423360.410000001
2023-04-17 06:30:00,29895.6,2023-04-17 18:00:00,29458.7,436.9,523797.31000000105,423797.31000000105
2023-04-17 18:15:00,29509.3,2023-04-18 00:00:00,29435.0,-74.3,523723.01000000106,423723.01000000106
2023-04-18 00:15:00,29386.4,2023-04-18 01:15:00,29272.0,114.4,523837.4100000011,423837.4100000011
2023-04-18 01:30:00,29382.8,2023-04-18 11:30:00,30236.67,853.87,524691.2800000011,424691.2800000011
2023-04-18 15:00:00,30105.9,2023-04-18 20:00:00,30230.1,-124.2,524567.080000001,424567.08000000106
2023-04-18 20:15:00,30248.9,2023-04-19 01:45:00,30222.6,-26.3,524540.7800000011,424540.7800000011
2023-04-19 02:00:00,30180.6,2023-04-19 10:45:00,29240.0,940.6,525481.380000001,425481.38000000105
2023-04-19 11:00:00,29254.6,2023-04-19 20:45:00,29222.9,-31.7,525449.6800000011,425449.68000000104
2023-04-19 21:00:00,29194.8,2023-04-20 04:00:00,28871.1,323.7,525773.380000001,425773.38000000105
2023-04-20 04:15:00,28915.9,2023-04-20 09:45:00,28852.2,-63.7,525709.6800000011,425709.68000000104
2023-04-20 10:00:00,28820.6,2023-04-20 12:15:00,28708.6,112.0,525821.6800000011,425821.68000000104
2023-04-20 12:30:00,28807.4,2023-04-20 15:15:00,28685.8,-121.6,525700.080000001,425700.08000000106
2023-04-20 15:30:00,28545.1,2023-04-21 03:00:00,28264.0,281.1,525981.1800000011,425981.18000000104
2023-04-21 03:15:00,28287.6,2023-04-21 06:15:00,28152.8,-134.8,525846.380000001,425846.38000000105
2023-04-21 06:30:00,28015.7,2023-04-21 12:00:00,28093.5,-77.8,525768.580000001,425768.58000000106
2023-04-21 12:15:00,28167.0,2023-04-21 16:00:00,28044.0,-123.0,525645.580000001,425645.58000000106
2023-04-21 16:15:00,27968.1,2023-04-22 01:15:00,27128.45,839.65,526485.2300000011,426485.2300000011
2023-04-22 04:00:00,27307.1,2023-04-22 08:00:00,27254.2,-52.9,526432.330000001,426432.33000000106
2023-04-22 08:15:00,27226.4,2023-04-22 12:15:00,27292.1,-65.7,526366.630000001,426366.63000000105
2023-04-22 12:30:00,27325.0,2023-04-23 00:15:00,27711.3,386.3,526752.9300000011,426752.93000000104
2023-04-23 00:30:00,27495.4,2023-04-23 05:45:00,27573.8,-78.4,526674.530000001,426674.530000001
2023-04-23 06:00:00,27580.2,2023-04-23 10:00:00,27622.0,41.8,526716.330000001,426716.330000001
2023-04-23 10:15:00,27541.5,2023-04-23 16:15:00,27524.9,16.6,526732.930000001,426732.930000001
2023-04-23 16:30:00,27616.4,2023-04-23 21:45:00,27499.4,-117.0,526615.930000001,426615.930000001
2023-04-23 22:00:00,27431.7,2023-04-24 00:30:00,27440.9,-9.2,526606.7300000009,426606.730000001
2023-04-24 00:45:00,27793.7,2023-04-24 00:45:00,27793.7,-294.0,526312.7300000009,426312.730000001
2023-04-24 02:30:00,27661.0,2023-04-24 10:45:00,27406.8,254.2,526566.930000001,426566.930000001
2023-04-24 11:00:00,27409.0,2023-04-24 14:15:00,27600.0,191.0,526757.930000001,426757.930000001
2023-04-24 14:30:00,27313.2,2023-04-24 17:15:00,27332.3,-19.1,526738.830000001,426738.830000001
2023-04-24 17:30:00,27360.0,2023-04-25 01:45:00,27386.5,26.5,526765.330000001,426765.330000001
2023-04-25 02:00:00,27331.2,2023-04-25 08:30:00,27350.1,-18.9,526746.430000001,426746.430000001
2023-04-25 08:45:00,27418.0,2023-04-26 01:45:00,28361.7,943.7,527690.130000001,427690.130000001
2023-04-26 06:15:00,28348.4,2023-04-26 08:00:00,28390.8,-42.4,527647.7300000009,427647.730000001
2023-04-26 08:15:00,28646.6,2023-04-26 17:30:00,29809.47,1162.87,528810.600000001,428810.60000000097
2023-04-26 19:00:00,29594.9,2023-04-26 20:30:00,28082.5,1512.4,530323.0000000009,430323.000000001
2023-04-26 20:45:00,28405.3,2023-04-27 06:30:00,28990.0,584.7,530907.700000001,430907.700000001
2023-04-27 06:45:00,28778.6,2023-04-27 10:45:00,28981.9,-203.3,530704.4000000011,430704.400000001
2023-04-27 11:00:00,29077.6,2023-04-27 15:15:00,29266.0,188.4,530892.800000001,430892.80000000104
2023-04-27 15:30:00,28952.0,2023-04-27 17:45:00,29282.6,-330.6,530562.2000000011,430562.20000000106
2023-04-27 18:00:00,29323.0,2023-04-27 22:30:00,29532.8,209.8,530772.000000001,430772.00000000105
2023-04-27 22:45:00,29375.6,2023-04-28 05:15:00,29475.6,-100.0,530672.000000001,430672.00000000105
2023-04-28 05:30:00,29520.0,2023-04-28 08:15:00,29352.5,-167.5,530504.500000001,430504.50000000105
2023-04-28 08:30:00,29199.9,2023-04-28 17:15:00,29207.8,-7.9,530496.600000001,430496.600000001
2023-04-28 17:30:00,29246.0,2023-04-29 08:45:00,29300.0,54.0,530550.600000001,430550.600000001
2023-04-29 09:00:00,29261.1,2023-04-29 13:30:00,29330.5,-69.4,530481.200000001,430481.200000001
2023-04-29 13:45:00,29371.9,2023-04-29 15:45:00,29258.1,-139.63,530341.570000001,430341.570000001
2023-04-29 16:30:00,29251.3,2023-04-29 17:45:00,29142.5,108.8,530450.370000001,430450.370000001
2023-04-29 18:00:00,29206.4,2023-04-30 00:30:00,29170.3,-36.1,530414.270000001,430414.270000001
2023-04-30 00:45:00,29124.3,2023-04-30 04:30:00,29183.9,-59.6,530354.6700000011,430354.67000000103
2023-04-30 04:45:00,29198.5,2023-04-30 09:15:00,29236.7,38.2,530392.870000001,430392.87000000104
2023-04-30 09:30:00,29227.5,2023-04-30 13:30:00,29259.2,-31.7,530361.1700000011,430361.17000000103
2023-04-30 13:45:00,29278.0,2023-04-30 18:15:00,29629.9,351.9,530713.070000001,430713.07000000105
2023-04-30 18:30:00,29600.0,2023-05-01 04:15:00,28529.06,1070.94,531784.010000001,431784.01000000106
2023-05-01 06:30:00,28537.2,2023-05-01 13:30:00,28514.9,-22.3,531761.7100000011,431761.71000000107
2023-05-01 13:45:00,28445.4,2023-05-01 22:45:00,28001.8,443.6,532205.310000001,432205.31000000105
2023-05-01 23:00:00,28096.4,2023-05-02 09:00:00,28016.6,-79.8,532125.510000001,432125.51000000106
2023-05-02 09:15:00,27949.5,2023-05-02 12:15:00,28029.8,-80.3,532045.2100000011,432045.21000000107
2023-05-02 12:30:00,28197.3,2023-05-02 13:15:00,28048.4,-148.9,531896.310000001,431896.31000000105
2023-05-02 13:30:00,27975.7,2023-05-02 14:00:00,28004.7,-29.0,531867.310000001,431867.31000000105
2023-05-02 14:15:00,28484.6,2023-05-02 14:15:00,28484.6,-352.51,531514.800000001,431514.80000000104
2023-05-03 00:00:00,28588.4,2023-05-03 06:15:00,28518.6,69.8,531584.600000001,431584.600000001
2023-05-03 06:30:00,28594.5,2023-05-03 11:30:00,28582.4,-12.1,531572.500000001,431572.50000000105
2023-05-03 11:45:00,28535.1,2023-05-03 16:00:00,28285.5,249.6,531822.100000001,431822.100000001
2023-05-03 16:15:00,28414.7,2023-05-03 20:15:00,28399.0,-15.7,531806.4000000011,431806.400000001
2023-05-03 20:30:00,28310.1,2023-05-03 21:00:00,28600.0,-289.9,531516.5000000009,431516.500000001
2023-05-03 21:15:00,28835.9,2023-05-04 07:45:00,29048.6,212.7,531729.200000001,431729.200000001
2023-05-04 08:00:00,28985.5,2023-05-04 10:15:00,29156.5,-171.0,531558.200000001,431558.200000001
2023-05-04 10:30:00,29265.0,2023-05-04 12:15:00,29175.8,-89.2,531469.0000000009,431469.000000001
2023-05-04 12:30:00,29048.0,2023-05-05 00:00:00,28837.8,210.2,531679.200000001,431679.200000001
2023-05-05 00:15:00,28877.3,2023-05-05 03:00:00,29249.7,372.4,532051.600000001,432051.600000001
2023-05-05 03:15:00,29238.4,2023-05-05 12:45:00,28939.1,299.3,532350.9000000011,432350.900000001
2023-05-05 13:00:00,28993.9,2023-05-06 01:30:00,29596.5,602.6,532953.5000000009,432953.500000001
2023-05-06 01:45:00,29535.2,2023-05-06 09:15:00,29286.1,249.1,533202.600000001,433202.60000000097
2023-05-06 09:30:00,29325.2,2023-05-06 12:15:00,29244.5,-80.7,533121.900000001,433121.90000000095
2023-05-06 12:30:00,29067.5,2023-05-06 16:00:00,28640.6,426.9,533548.800000001,433548.800000001
2023-05-06 16:15:00,28678.5,2023-05-06 21:15:00,28754.2,75.7,533624.5000000009,433624.500000001
2023-05-06 21:30:00,28649.2,2023-05-07 00:30:00,28822.4,-173.2,533451.300000001,433451.300000001
2023-05-07 00:45:00,28929.5,2023-05-07 02:15:00,28877.0,-52.5,533398.800000001,433398.800000001
2023-05-07 02:30:00,28829.9,2023-05-07 07:45:00,28891.9,-62.0,533336.800000001,433336.800000001
2023-05-07 08:00:00,28922.5,2023-05-07 11:00:00,28788.9,-133.6,533203.200000001,433203.200000001
2023-05-07 11:15:00,28751.6,2023-05-07 12:15:00,28879.0,-127.4,533075.800000001,433075.800000001
2023-05-07 12:30:00,28916.0,2023-05-07 18:30:00,28912.0,-4.0,533071.800000001,433071.800000001
2023-05-07 18:45:00,28843.4,2023-05-08 07:30:00,28041.4,802.0,533873.800000001,433873.800000001
2023-05-08 09:45:00,27900.0,2023-05-08 17:15:00,27875.1,-24.9,533848.900000001,433848.90000000095
2023-05-08 17:30:00,27745.5,2023-05-08 22:15:00,27587.8,157.7,534006.600000001,434006.60000000097
2023-05-08 22:30:00,27612.8,2023-05-09 05:45:00,27540.2,-72.6,533934.0000000009,433934.000000001
2023-05-09 06:00:00,27469.4,2023-05-09 10:00:00,27554.9,-85.5,533848.5000000009,433848.500000001
2023-05-09 10:15:00,27611.2,2023-05-09 13:45:00,27605.4,-5.8,533842.700000001,433842.700000001
2023-05-09 14:00:00,27452.0,2023-05-09 16:30:00,27462.2,-10.2,533832.5000000009,433832.500000001
2023-05-09 16:45:00,27691.2,2023-05-10 03:45:00,27668.8,-22.4,533810.100000001,433810.10000000097
2023-05-10 04:00:00,27663.7,2023-05-10 11:30:00,27596.1,67.6,533877.7000000009,433877.70000000094
2023-05-10 11:45:00,27660.7,2023-05-10 16:45:00,28166.6,505.9,534383.600000001,434383.60000000097
2023-05-10 17:00:00,27872.8,2023-05-10 17:15:00,27130.1,742.7,535126.300000001,435126.300000001
2023-05-10 17:30:00,27318.7,2023-05-11 00:00:00,27582.7,264.0,535390.300000001,435390.300000001
2023-05-11 00:15:00,27533.2,2023-05-11 10:00:00,27419.8,113.4,535503.700000001,435503.700000001
2023-05-11 10:15:00,27434.5,2023-05-11 12:45:00,27385.3,-49.2,535454.5000000009,435454.500000001
2023-05-11 13:00:00,27320.7,2023-05-11 23:15:00,26922.1,398.6,535853.100000001,435853.10000000097
2023-05-11 23:30:00,27009.5,2023-05-12 02:00:00,26853.9,-155.6,535697.5000000009,435697.500000001
2023-05-12 02:15:00,26827.5,2023-05-12 09:45:00,26368.6,458.9,536156.4000000011,436156.400000001
2023-05-12 10:00:00,26398.1,2023-05-12 14:30:00,26413.2,15.1,536171.5000000009,436171.500000001
2023-05-12 14:45:00,26302.1,2023-05-12 19:15:00,25928.3,373.8,536545.300000001,436545.300000001
2023-05-12 19:30:00,26129.6,2023-05-13 04:15:00,26799.12,669.52,537214.820000001,437214.820000001
2023-05-13 05:30:00,26754.2,2023-05-13 10:45:00,26817.8,-63.6,537151.220000001,437151.220000001
2023-05-13 11:00:00,26824.0,2023-05-13 19:15:00,26898.2,74.2,537225.4200000011,437225.42000000103
2023-05-13 19:30:00,26793.3,2023-05-14 02:00:00,26726.5,66.8,537292.220000001,437292.220000001
2023-05-14 02:15:00,26784.8,2023-05-14 11:30:00,26801.0,16.2,537308.4200000011,437308.42000000103
2023-05-14 11:45:00,26794.8,2023-05-14 12:30:00,26794.3,0.5,537308.9200000011,437308.92000000103
2023-05-14 12:45:00,26861.1,2023-05-14 16:30:00,27001.5,140.4,537449.320000001,437449.32000000105
2023-05-14 16:45:00,26942.0,2023-05-15 01:00:00,26816.4,125.6,537574.9200000011,437574.92000000103
2023-05-15 01:15:00,26975.9,2023-05-15 11:15:00,27395.8,419.9,537994.820000001,437994.82000000105
2023-05-15 11:30:00,27343.8,2023-05-15 16:00:00,27421.4,-77.6,537917.2200000011,437917.2200000011
2023-05-15 16:15:00,27467.3,2023-05-15 19:45:00,27410.1,-57.2,537860.0200000011,437860.02000000107
2023-05-15 20:00:00,27379.9,2023-05-16 03:15:00,27079.1,300.8,538160.820000001,438160.82000000105
2023-05-16 03:30:00,27112.3,2023-05-16 10:00:00,27088.8,-23.5,538137.320000001,438137.32000000105
2023-05-16 10:15:00,27016.7,2023-05-16 23:45:00,27024.8,-8.1,538129.2200000011,438129.2200000011
2023-05-17 00:00:00,27043.0,2023-05-17 03:30:00,27110.0,67.0,538196.2200000011,438196.2200000011
2023-05-17 03:45:00,27052.1,2023-05-17 10:00:00,26829.6,222.5,538418.7200000011,438418.7200000011
2023-05-17 10:15:00,26879.9,2023-05-17 11:00:00,26812.5,-67.4,538351.320000001,438351.32000000105
2023-05-17 11:15:00,26717.0,2023-05-17 16:15:00,26775.0,-58.0,538293.320000001,438293.32000000105
2023-05-17 16:30:00,26850.0,2023-05-18 03:45:00,27354.96,504.96,538798.2800000011,438798.2800000011
2023-05-18 04:00:00,27334.3,2023-05-18 07:15:00,27218.0,116.3,538914.580000001,438914.58000000106
2023-05-18 07:30:00,27341.1,2023-05-18 12:30:00,27282.8,-58.3,538856.2800000011,438856.2800000011
2023-05-18 12:45:00,27224.6,2023-05-18 19:15:00,26616.2,608.4,539464.6800000011,439464.6800000011
2023-05-18 19:30:00,26776.0,2023-05-19 01:15:00,26824.5,48.5,539513.1800000011,439513.1800000011
2023-05-19 01:30:00,26768.2,2023-05-19 06:15:00,26887.7,-159.3,539353.880000001,439353.8800000011
2023-05-19 06:30:00,26895.4,2023-05-19 10:45:00,26810.9,-84.5,539269.380000001,439269.3800000011
2023-05-19 11:00:00,26788.9,2023-05-19 12:00:00,26934.5,-160.07,539109.3100000011,439109.3100000011
2023-05-19 17:15:00,26919.3,2023-05-20 00:15:00,26869.7,-49.6,539059.7100000011,439059.7100000011
2023-05-20 00:30:00,26824.2,2023-05-20 08:30:00,26862.9,-38.7,539021.0100000012,439021.0100000011
2023-05-20 08:45:00,26894.5,2023-05-20 20:30:00,27027.3,132.8,539153.8100000011,439153.8100000011
2023-05-20 20:45:00,27002.2,2023-05-20 23:15:00,27051.8,-49.6,539104.2100000011,439104.2100000011
2023-05-20 23:30:00,27080.9,2023-05-21 02:00:00,27171.1,90.2,539194.4100000011,439194.41000000114
2023-05-21 02:15:00,27148.2,2023-05-21 13:00:00,26900.2,248.0,539442.4100000011,439442.41000000114
2023-05-21 13:15:00,26919.1,2023-05-21 20:30:00,26843.0,-76.1,539366.3100000012,439366.31000000116
2023-05-21 20:45:00,26828.7,2023-05-22 04:00:00,26640.3,188.4,539554.7100000011,439554.7100000012
2023-05-22 04:15:00,26678.5,2023-05-22 12:30:00,26776.9,98.4,539653.1100000013,439653.1100000012
2023-05-22 12:45:00,26718.0,2023-05-22 13:15:00,26762.3,-44.3,539608.8100000012,439608.8100000012
2023-05-22 13:30:00,27004.4,2023-05-22 13:30:00,27004.4,-202.8,539406.0100000012,439406.01000000123
2023-05-22 16:45:00,26862.5,2023-05-23 00:15:00,26875.5,-13.0,539393.0100000012,439393.01000000123
2023-05-23 00:30:00,26900.0,2023-05-23 06:30:00,27317.6,417.6,539810.6100000013,439810.6100000012
2023-05-23 06:45:00,27284.4,2023-05-23 12:00:00,27350.9,-66.5,539744.1100000013,439744.1100000012
2023-05-23 12:15:00,27381.1,2023-05-23 13:30:00,27220.3,-181.68,539562.4300000012,439562.4300000012
2023-05-23 17:15:00,27184.3,2023-05-23 23:00:00,27191.7,-7.4,539555.0300000012,439555.0300000012
2023-05-23 23:15:00,27238.3,2023-05-24 02:00:00,27150.1,-134.51,539420.5200000012,439420.5200000012
2023-05-24 03:00:00,27090.3,2023-05-24 09:00:00,26740.5,349.8,539770.3200000012,439770.3200000012
2023-05-24 09:15:00,26777.0,2023-05-24 13:00:00,26682.4,-94.6,539675.7200000011,439675.7200000012
2023-05-24 13:15:00,26669.8,2023-05-24 20:00:00,26242.3,427.5,540103.2200000011,440103.2200000012
2023-05-24 20:15:00,26410.6,2023-05-25 00:15:00,26276.0,-134.6,539968.6200000013,439968.6200000012
2023-05-25 00:30:00,26209.3,2023-05-25 02:45:00,26114.3,95.0,540063.6200000013,440063.6200000012
2023-05-25 03:00:00,26142.2,2023-05-25 15:15:00,26253.8,111.6,540175.2200000011,440175.2200000012
2023-05-25 15:30:00,26205.4,2023-05-25 18:00:00,26327.8,-122.4,540052.8200000012,440052.8200000012
2023-05-25 18:15:00,26393.6,2023-05-25 21:00:00,26444.8,51.2,540104.0200000012,440104.0200000012
2023-05-25 21:15:00,26438.6,2023-05-26 07:15:00,26431.6,7.0,540111.0200000012,440111.0200000012
2023-05-26 07:30:00,26456.8,2023-05-26 11:15:00,26440.0,-16.8,540094.2200000011,440094.2200000012
2023-05-26 11:30:00,26425.1,2023-05-26 13:15:00,26456.7,-31.6,540062.6200000013,440062.6200000012
2023-05-26 13:30:00,26536.8,2023-05-26 17:30:00,26740.1,203.3,540265.9200000012,440265.9200000012
2023-05-26 17:45:00,26707.1,2023-05-27 02:30:00,26703.7,3.4,540269.3200000012,440269.32000000123
2023-05-27 02:45:00,26734.9,2023-05-27 07:45:00,26715.3,-19.6,540249.7200000013,440249.72000000125
2023-05-27 08:00:00,26683.1,2023-05-27 13:00:00,26707.0,-23.9,540225.8200000012,440225.82000000123
2023-05-27 13:15:00,26757.1,2023-05-27 13:30:00,26715.7,-41.4,540184.4200000012,440184.4200000012
2023-05-27 13:45:00,26617.8,2023-05-27 14:00:00,26651.5,-33.7,540150.7200000011,440150.7200000012
2023-05-27 14:15:00,26686.7,2023-05-27 18:30:00,26783.2,96.5,540247.2200000011,440247.2200000012
2023-05-27 18:45:00,26689.6,2023-05-27 22:15:00,26778.5,-88.9,540158.3200000012,440158.3200000012
2023-05-27 22:30:00,26805.8,2023-05-28 07:45:00,27207.83,402.03,540560.3500000013,440560.3500000012
2023-05-28 09:30:00,27132.7,2023-05-28 11:15:00,27192.6,-144.91,540415.4400000012,440415.4400000012
2023-05-28 15:30:00,27229.8,2023-05-28 20:30:00,27578.7,348.9,540764.3400000012,440764.34000000125
2023-05-28 20:45:00,27546.1,2023-05-28 21:30:00,27685.5,-139.4,540624.9400000012,440624.9400000012
2023-05-28 21:45:00,27828.5,2023-05-29 02:00:00,28150.9,322.4,540947.3400000012,440947.34000000125
2023-05-29 02:15:00,28114.2,2023-05-29 12:45:00,27871.0,243.2,541190.5400000012,441190.54000000126
2023-05-29 13:00:00,27912.0,2023-05-29 14:45:00,27782.0,-205.86,540984.6800000013,440984.6800000013
2023-05-29 15:15:00,27640.0,2023-05-29 22:45:00,27678.7,-38.7,540945.9800000013,440945.98000000126
2023-05-29 23:00:00,27788.1,2023-05-30 00:30:00,27655.9,-213.92,540732.0600000012,440732.0600000013
2023-05-30 04:30:00,27754.7,2023-05-30 09:00:00,27805.0,-50.3,540681.7600000013,440681.7600000013
2023-05-30 09:15:00,27814.4,2023-05-30 12:15:00,27880.1,65.7,540747.4600000014,440747.4600000013
2023-05-30 12:30:00,27810.6,2023-05-30 18:45:00,27750.3,60.3,540807.7600000013,440807.7600000013
2023-05-30 19:00:00,27778.3,2023-05-30 23:45:00,27680.1,-98.2,540709.5600000012,440709.5600000013
2023-05-31 00:00:00,27679.3,2023-05-31 10:15:00,27066.28,613.02,541322.5800000012,441322.5800000013
2023-05-31 13:00:00,27156.5,2023-05-31 14:00:00,27043.1,-113.4,541209.1800000013,441209.1800000013
2023-05-31 14:15:00,26890.9,2023-05-31 19:15:00,27015.7,-124.8,541084.3800000013,441084.3800000013
2023-05-31 19:30:00,27076.3,2023-06-01 00:15:00,27269.1,192.8,541277.1800000013,441277.1800000013
2023-06-01 00:30:00,27100.0,2023-06-01 05:15:00,26823.9,276.1,541553.2800000012,441553.28000000125
2023-06-01 05:30:00,26818.9,2023-06-01 19:00:00,26951.0,132.1,541685.3800000013,441685.3800000012
2023-06-01 19:15:00,26857.1,2023-06-01 20:45:00,26850.4,6.7,541692.0800000012,441692.08000000124
2023-06-01 21:00:00,26904.4,2023-06-02 00:00:00,26787.2,-117.2,541574.8800000013,441574.8800000012
2023-06-02 00:15:00,26702.9,2023-06-02 00:30:00,26717.3,-14.4,541560.4800000011,441560.4800000012
2023-06-02 00:45:00,26779.9,2023-06-02 13:30:00,27058.6,278.7,541839.1800000012,441839.1800000012
2023-06-02 13:45:00,26896.4,2023-06-02 15:30:00,26991.4,-95.0,541744.1800000012,441744.1800000012
2023-06-02 15:45:00,27081.3,2023-06-03 01:00:00,27169.4,88.1,541832.2800000012,441832.2800000012
2023-06-03 01:15:00,27130.4,2023-06-03 06:00:00,27158.5,-28.1,541804.1800000012,441804.1800000012
2023-06-03 06:15:00,27185.2,2023-06-03 09:00:00,27140.5,-44.7,541759.4800000011,441759.4800000012
2023-06-03 09:15:00,27131.3,2023-06-03 13:45:00,27157.1,-25.8,541733.6800000012,441733.6800000012
2023-06-03 14:00:00,27179.4,2023-06-03 17:00:00,27204.1,24.7,541758.3800000013,441758.3800000012
2023-06-03 17:15:00,27165.7,2023-06-03 22:30:00,27052.7,113.0,541871.3800000013,441871.3800000012
2023-06-03 22:45:00,27060.4,2023-06-04 16:00:00,27182.0,121.6,541992.9800000011,441992.9800000012
2023-06-04 16:15:00,27168.1,2023-06-04 20:45:00,27233.2,-88.03,541904.9500000011,441904.9500000012
2023-06-04 21:00:00,27250.4,2023-06-04 22:30:00,27300.0,49.6,541954.5500000012,441954.55000000115
2023-06-04 22:45:00,27221.1,2023-06-05 08:45:00,26790.32,430.78,542385.3300000012,442385.3300000012
2023-06-05 22:30:00,25749.2,2023-06-06 07:30:00,25723.9,-25.3,542360.0300000012,442360.0300000012
2023-06-06 07:45:00,25706.4,2023-06-06 13:30:00,25634.4,72.0,542432.0300000012,442432.0300000012
2023-06-06 13:45:00,25720.0,2023-06-06 19:45:00,27100.27,1380.27,543812.3000000012,443812.3000000012
2023-06-07 02:00:00,27021.8,2023-06-07 10:45:00,26582.9,438.9,544251.2000000012,444251.20000000123
2023-06-07 11:00:00,26659.4,2023-06-07 14:15:00,26644.4,-15.0,544236.2000000012,444236.20000000123
2023-06-07 14:30:00,26499.5,2023-06-08 00:45:00,26375.7,123.8,544360.0000000012,444360.0000000012
2023-06-08 01:00:00,26447.1,2023-06-08 03:15:00,26232.9,-248.85,544111.1500000013,444111.15000000125
2023-06-08 13:00:00,26367.8,2023-06-08 14:15:00,26472.7,-104.9,544006.2500000012,444006.2500000012
2023-06-08 14:30:00,26569.2,2023-06-08 16:30:00,26527.3,-41.9,543964.3500000013,443964.3500000012
2023-06-08 16:45:00,26488.0,2023-06-08 20:30:00,26595.6,-107.6,543856.7500000012,443856.7500000012
2023-06-08 20:45:00,26626.0,2023-06-08 23:30:00,26500.2,-125.8,543730.9500000012,443730.95000000123
2023-06-08 23:45:00,26485.9,2023-06-09 02:45:00,26448.0,37.9,543768.8500000013,443768.85000000126
2023-06-09 03:00:00,26457.5,2023-06-09 14:15:00,26670.9,213.4,543982.2500000013,443982.2500000013
2023-06-09 14:30:00,26579.9,2023-06-10 09:30:00,25638.05,941.85,544924.1000000013,444924.10000000126
2023-06-10 11:30:00,25698.9,2023-06-10 17:00:00,25670.3,-240.76,544683.3400000012,444683.34000000125
2023-06-10 18:15:00,25608.0,2023-06-10 20:00:00,25687.8,-79.8,544603.5400000012,444603.54000000126
2023-06-10 20:15:00,25720.0,2023-06-11 03:30:00,25736.9,16.9,544620.4400000013,444620.4400000013
2023-06-11 03:45:00,25714.7,2023-06-11 05:30:00,25771.4,-56.7,544563.7400000013,444563.7400000013
2023-06-11 05:45:00,25805.8,2023-06-11 13:30:00,25758.1,-47.7,544516.0400000012,444516.04000000126
2023-06-11 13:45:00,25693.2,2023-06-11 16:00:00,25769.9,-76.7,544439.3400000012,444439.34000000125
2023-06-11 16:15:00,25823.2,2023-06-11 22:15:00,25978.5,155.3,544594.6400000013,444594.64000000124
2023-06-11 22:30:00,25782.1,2023-06-12 06:00:00,25786.9,-4.8,544589.8400000012,444589.84000000125
2023-06-12 06:15:00,25855.0,2023-06-12 12:00:00,25941.2,86.2,544676.0400000012,444676.04000000126
2023-06-12 12:15:00,25903.6,2023-06-12 20:00:00,25815.0,88.6,544764.6400000013,444764.64000000124
2023-06-12 20:15:00,25869.6,2023-06-13 11:15:00,26145.9,276.3,545040.9400000012,445040.9400000012
2023-06-13 11:30:00,26087.7,2023-06-13 12:30:00,26080.1,-264.9,544776.0400000012,444776.0400000012
2023-06-13 23:45:00,25918.0,2023-06-14 05:15:00,25951.9,33.9,544809.9400000012,444809.9400000012
2023-06-14 05:30:00,25875.6,2023-06-14 09:15:00,25920.0,-44.4,544765.5400000012,444765.5400000012
2023-06-14 09:30:00,25967.6,2023-06-14 16:45:00,25955.8,-11.8,544753.7400000012,444753.7400000012
2023-06-14 17:00:00,25931.5,2023-06-15 00:15:00,25123.1,808.4,545562.1400000013,445562.14000000124
2023-06-15 00:30:00,25138.1,2023-06-15 04:00:00,25015.4,-122.7,545439.4400000012,445439.4400000012
2023-06-15 04:15:00,24996.9,2023-06-15 11:15:00,24903.1,93.8,545533.2400000012,445533.2400000012
2023-06-15 11:30:00,25002.6,2023-06-15 20:00:00,25404.2,401.6,545934.8400000012,445934.8400000012
2023-06-15 20:15:00,25224.8,2023-06-15 20:30:00,25322.7,-97.9,545836.9400000011,445836.94000000117
2023-06-15 20:45:00,25556.7,2023-06-16 00:30:00,25495.1,-61.6,545775.3400000012,445775.3400000012
2023-06-16 00:45:00,25482.7,2023-06-16 08:00:00,25572.0,-89.3,545686.0400000012,445686.0400000012
2023-06-16 08:15:00,25592.5,2023-06-16 11:30:00,25482.8,-109.7,545576.3400000012,445576.3400000012
2023-06-16 11:45:00,25462.8,2023-06-16 13:00:00,25576.4,-113.6,545462.7400000012,445462.7400000012
2023-06-16 13:15:00,25598.0,2023-06-16 14:45:00,25602.2,-263.22,545199.5200000012,445199.52000000124
2023-06-17 00:15:00,26320.5,2023-06-17 04:15:00,26285.0,35.5,545235.0200000012,445235.02000000124
2023-06-17 04:30:00,26303.7,2023-06-17 06:45:00,26654.6,350.9,545585.9200000013,445585.92000000126
2023-06-17 07:00:00,26636.3,2023-06-17 18:15:00,26445.1,191.2,545777.1200000013,445777.1200000013
2023-06-17 18:30:00,26514.0,2023-06-18 00:15:00,26475.7,-38.3,545738.8200000012,445738.8200000013
2023-06-18 00:30:00,26406.8,2023-06-18 02:45:00,26467.4,-60.6,545678.2200000014,445678.2200000013
2023-06-18 03:00:00,26489.3,2023-06-18 08:30:00,26518.4,29.1,545707.3200000012,445707.3200000013
2023-06-18 08:45:00,26488.7,2023-06-18 16:00:00,26547.5,-58.8,545648.5200000013,445648.5200000013
2023-06-18 16:15:00,26593.9,2023-06-18 20:00:00,26503.5,-90.4,545558.1200000013,445558.1200000013
2023-06-18 20:15:00,26453.0,2023-06-19 01:30:00,26409.5,43.5,545601.6200000013,445601.6200000013
2023-06-19 01:45:00,26429.0,2023-06-19 10:30:00,26389.3,-39.7,545561.9200000013,445561.92000000126
2023-06-19 10:45:00,26365.7,2023-06-19 12:00:00,26425.0,-59.3,545502.6200000013,445502.6200000013
2023-06-19 12:15:00,26513.6,2023-06-19 14:15:00,26439.6,-74.0,545428.6200000013,445428.6200000013
2023-06-19 14:30:00,26398.3,2023-06-19 16:30:00,26450.6,-52.3,545376.3200000012,445376.3200000013
2023-06-19 16:45:00,26489.7,2023-06-19 18:30:00,26853.6,363.9,545740.2200000014,445740.2200000013
2023-06-19 18:45:00,26483.8,2023-06-19 18:45:00,26483.8,-374.0,545366.2200000014,445366.2200000013
2023-06-19 20:00:00,26805.5,2023-06-20 03:15:00,26928.3,122.8,545489.0200000013,445489.0200000013
2023-06-20 03:30:00,26895.0,2023-06-20 11:30:00,26806.0,89.0,545578.0200000013,445578.0200000013
2023-06-20 11:45:00,26895.2,2023-06-20 14:00:00,26793.1,-102.1,545475.9200000013,445475.9200000013
2023-06-20 14:15:00,26659.0,2023-06-20 15:30:00,26851.8,-224.08,545251.8400000012,445251.8400000013
2023-06-20 15:45:00,27054.2,2023-06-20 23:15:00,28320.82,1266.62,546518.4600000014,446518.4600000013
2023-06-21 04:00:00,28681.2,2023-06-21 09:45:00,28907.3,-255.45,546263.0100000013,446263.0100000013
2023-06-21 10:00:00,28951.4,2023-06-21 10:30:00,28886.0,-65.4,546197.6100000013,446197.61000000127
2023-06-21 10:45:00,28821.8,2023-06-21 13:30:00,29095.3,-273.5,545924.1100000013,445924.11000000127
2023-06-21 13:45:00,29296.7,2023-06-21 17:15:00,29962.4,665.7,546589.8100000012,446589.8100000013
2023-06-21 17:30:00,29883.9,2023-06-22 02:00:00,30147.3,-263.4,546326.4100000013,446326.41000000125
2023-06-22 02:15:00,30269.8,2023-06-22 05:45:00,30277.2,7.4,546333.8100000012,446333.8100000013
2023-06-22 06:00:00,30078.0,2023-06-22 12:45:00,30099.2,-21.2,546312.6100000013,446312.61000000127
2023-06-22 13:00:00,30140.8,2023-06-22 14:15:00,30146.7,5.9,546318.5100000013,446318.5100000013
2023-06-22 14:30:00,29723.0,2023-06-22 16:00:00,29936.1,-213.1,546105.4100000013,446105.4100000013
2023-06-22 16:15:00,30090.3,2023-06-22 22:30:00,30009.4,-80.9,546024.5100000013,446024.5100000013
2023-06-22 22:45:00,29917.6,2023-06-23 03:45:00,30002.4,-84.8,545939.7100000014,445939.7100000013
2023-06-23 04:00:00,30015.1,2023-06-23 19:15:00,30881.2,866.1,546805.8100000012,446805.8100000013
2023-06-23 19:30:00,30777.8,2023-06-24 02:15:00,30628.0,149.8,546955.6100000013,446955.61000000127
2023-06-24 02:30:00,30770.1,2023-06-24 07:30:00,30593.6,-176.5,546779.1100000013,446779.11000000127
2023-06-24 07:45:00,30563.4,2023-06-24 10:30:00,30700.0,-136.6,546642.5100000013,446642.5100000013
2023-06-24 10:45:00,30730.0,2023-06-24 15:00:00,30596.3,-133.7,546508.8100000012,446508.8100000013
2023-06-24 15:15:00,30556.9,2023-06-24 16:45:00,30504.0,52.9,546561.7100000014,446561.7100000013
2023-06-24 17:00:00,30569.1,2023-06-24 20:45:00,30503.9,-65.2,546496.5100000013,446496.5100000013
2023-06-24 21:00:00,30401.9,2023-06-25 01:45:00,30591.1,-211.04,546285.4700000014,446285.4700000013
2023-06-25 02:00:00,30602.2,2023-06-25 05:45:00,30850.3,248.1,546533.5700000012,446533.5700000013
2023-06-25 06:00:00,30780.1,2023-06-25 22:00:00,30493.2,286.9,546820.4700000014,446820.4700000013
2023-06-25 22:15:00,30535.4,2023-06-26 00:45:00,30378.9,-156.5,546663.9700000014,446663.9700000013
2023-06-26 01:00:00,30150.6,2023-06-26 03:15:00,30226.6,-76.0,546587.9700000014,446587.9700000013
2023-06-26 03:30:00,30270.2,2023-06-26 09:30:00,30327.2,57.0,546644.9700000014,446644.9700000013
2023-06-26 09:45:00,30257.2,2023-06-26 12:15:00,30282.6,-25.4,546619.5700000012,446619.5700000013
2023-06-26 12:30:00,30370.7,2023-06-26 14:15:00,30504.0,133.3,546752.8700000013,446752.8700000013
2023-06-26 14:30:00,30286.5,2023-06-26 19:45:00,30233.9,52.6,546805.4700000013,446805.47000000125
2023-06-26 20:00:00,30258.4,2023-06-27 05:00:00,30344.8,86.4,546891.8700000013,446891.8700000013
2023-06-27 05:15:00,30299.5,2023-06-27 08:00:00,30386.1,-86.6,546805.2700000013,446805.2700000013
2023-06-27 08:15:00,30406.0,2023-06-27 15:00:00,30638.1,232.1,547037.3700000013,447037.3700000013
2023-06-27 15:15:00,30558.1,2023-06-27 18:45:00,30677.4,-119.3,546918.0700000012,446918.0700000013
2023-06-27 19:00:00,30686.1,2023-06-28 02:30:00,30522.4,-163.7,546754.3700000013,446754.3700000013
2023-06-28 02:45:00,30404.2,2023-06-28 10:30:00,30304.5,99.7,546854.0700000012,446854.0700000013
2023-06-28 10:45:00,30324.8,2023-06-28 12:30:00,30141.4,-183.4,546670.6700000013,446670.67000000126
2023-06-28 12:45:00,30091.6,2023-06-28 14:15:00,30262.2,-170.6,546500.0700000012,446500.0700000013
2023-06-28 14:30:00,30444.1,2023-06-28 16:45:00,30242.4,-201.7,546298.3700000013,446298.3700000013
2023-06-28 17:00:00,30102.4,2023-06-28 21:15:00,30085.0,17.4,546315.7700000013,446315.7700000013
2023-06-28 21:30:00,30167.1,2023-06-29 14:30:00,30528.1,361.0,546676.7700000013,446676.7700000013
2023-06-29 14:45:00,30434.5,2023-06-29 23:00:00,30395.7,38.8,546715.5700000012,446715.5700000013
2023-06-29 23:15:00,30472.0,2023-06-30 05:15:00,30887.5,415.5,547131.0700000012,447131.0700000013
2023-06-30 05:30:00,30778.5,2023-06-30 11:30:00,30823.4,-44.9,547086.1700000013,447086.17000000126
2023-06-30 11:45:00,30897.7,2023-06-30 13:15:00,31048.8,151.1,547237.2700000012,447237.27000000124
2023-06-30 13:30:00,30295.5,2023-06-30 13:30:00,30295.5,-550.82,546686.4500000012,446686.45000000123
2023-06-30 14:00:00,30269.1,2023-06-30 23:45:00,30460.2,191.1,546877.5500000012,446877.5500000012
2023-07-01 00:00:00,30438.6,2023-07-01 07:30:00,30424.5,14.1,546891.6500000012,446891.6500000012
2023-07-01 07:45:00,30448.1,2023-07-01 21:15:00,30577.2,129.1,547020.7500000012,447020.75000000116
2023-07-01 21:30:00,30570.0,2023-07-02 00:00:00,30550.6,19.4,547040.1500000012,447040.1500000012
2023-07-02 00:15:00,30646.3,2023-07-02 00:15:00,30646.3,-107.95,546932.2000000011,446932.2000000012
2023-07-02 03:30:00,30513.0,2023-07-02 14:15:00,30524.3,-11.3,546920.9000000012,446920.9000000012
2023-07-02 14:30:00,30607.5,2023-07-02 15:15:00,30467.8,-203.74,546717.1600000012,446717.1600000012
2023-07-02 17:45:00,30434.2,2023-07-02 19:30:00,30542.5,-108.3,546608.8600000013,446608.8600000012
2023-07-02 19:45:00,30552.8,2023-07-03 06:00:00,30642.9,90.1,546698.9600000011,446698.9600000012
2023-07-03 06:15:00,30633.1,2023-07-03 14:15:00,30657.7,-24.6,546674.3600000013,446674.3600000012
2023-07-03 14:30:00,30747.3,2023-07-03 21:00:00,31084.0,336.7,547011.0600000012,447011.0600000012
2023-07-03 21:15:00,31016.0,2023-07-03 23:30:00,31126.5,-110.5,546900.5600000012,446900.5600000012
2023-07-03 23:45:00,31149.0,2023-07-04 04:15:00,31116.3,-32.7,546867.8600000013,446867.8600000012
2023-07-04 04:30:00,31029.1,2023-07-04 11:30:00,31009.1,20.0,546887.8600000013,446887.8600000012
2023-07-04 11:45:00,31056.5,2023-07-04 16:45:00,30946.8,-253.22,546634.6400000013,446634.64000000124
2023-07-04 17:30:00,30887.7,2023-07-04 22:30:00,30766.3,121.4,546756.0400000012,446756.04000000126
2023-07-04 22:45:00,30808.8,2023-07-05 07:15:00,30773.5,-35.3,546720.7400000013,446720.7400000013
2023-07-05 07:30:00,30763.7,2023-07-05 16:30:00,30431.8,331.9,547052.6400000013,447052.6400000013
2023-07-05 16:45:00,30447.1,2023-07-06 01:00:00,30409.4,-37.7,547014.9400000013,447014.9400000013
2023-07-06 01:15:00,30382.5,2023-07-06 03:00:00,30480.0,-97.5,546917.4400000013,446917.4400000013
2023-07-06 03:15:00,30492.9,2023-07-06 08:45:00,31326.29,833.39,547750.8300000012,447750.8300000013
2023-07-06 09:30:00,31159.0,2023-07-06 15:15:00,30238.1,920.9,548671.7300000014,448671.7300000013
2023-07-06 15:30:00,30406.0,2023-07-06 22:30:00,30209.7,-196.3,548475.4300000013,448475.43000000133
2023-07-06 22:45:00,30147.5,2023-07-07 01:15:00,29997.3,150.2,548625.6300000013,448625.63000000134
2023-07-07 01:30:00,30074.9,2023-07-07 07:30:00,30080.1,5.2,548630.8300000014,448630.83000000136
2023-07-07 07:45:00,29992.9,2023-07-07 09:15:00,30142.1,-149.2,548481.6300000013,448481.63000000134
2023-07-07 09:30:00,30150.0,2023-07-07 18:00:00,30227.2,77.2,548558.8300000014,448558.83000000136
2023-07-07 18:15:00,30186.9,2023-07-07 20:45:00,30248.8,-61.9,548496.9300000013,448496.93000000133
2023-07-07 21:00:00,30306.5,2023-07-08 03:45:00,30260.0,-46.5,548450.4300000013,448450.43000000133
2023-07-08 04:00:00,30240.6,2023-07-08 08:00:00,30208.5,32.1,548482.5300000013,448482.5300000013
2023-07-08 08:15:00,30256.6,2023-07-08 10:15:00,30222.5,-34.1,548448.4300000013,448448.43000000133
2023-07-08 10:30:00,30210.2,2023-07-08 16:15:00,30210.8,-0.6,548447.8300000014,448447.83000000136
2023-07-08 16:30:00,30269.9,2023-07-08 17:45:00,30240.8,-29.1,548418.7300000014,448418.7300000014
2023-07-08 18:00:00,30198.9,2023-07-08 21:00:00,30146.6,52.3,548471.0300000014,448471.03000000137
2023-07-08 21:15:00,30180.1,2023-07-09 03:00:00,30280.4,100.3,548571.3300000014,448571.33000000136
2023-07-09 03:15:00,30260.3,2023-07-09 12:30:00,30287.1,-26.8,548544.5300000014,448544.53000000137
2023-07-09 12:45:00,30320.0,2023-07-09 13:45:00,30248.0,-72.0,548472.5300000014,448472.53000000137
2023-07-09 14:00:00,30202.1,2023-07-09 14:30:00,30309.4,-153.66,548318.8700000014,448318.8700000014
2023-07-09 14:45:00,30328.0,2023-07-09 18:00:00,30265.0,-63.0,548255.8700000014,448255.8700000014
2023-07-09 18:15:00,30251.9,2023-07-10 02:30:00,30096.2,155.7,548411.5700000015,448411.5700000014
2023-07-10 02:45:00,30187.1,2023-07-10 05:30:00,30087.8,-99.3,548312.2700000014,448312.2700000014
2023-07-10 05:45:00,30068.0,2023-07-10 09:00:00,30040.0,28.0,548340.2700000014,448340.2700000014
2023-07-10 09:15:00,30163.6,2023-07-10 20:00:00,31038.21,874.61,549214.8800000014,449214.8800000014
2023-07-10 21:00:00,30651.9,2023-07-11 00:45:00,30405.6,246.3,549461.1800000013,449461.1800000014
2023-07-11 01:00:00,30435.0,2023-07-11 08:30:00,30519.9,84.9,549546.0800000015,449546.0800000014
2023-07-11 08:45:00,30482.1,2023-07-11 14:00:00,30384.8,97.3,549643.3800000014,449643.3800000014
2023-07-11 14:15:00,30493.3,2023-07-11 18:00:00,30548.8,55.5,549698.8800000014,449698.8800000014
2023-07-11 18:15:00,30476.0,2023-07-11 22:30:00,30517.1,-41.1,549657.7800000014,449657.7800000014
2023-07-11 22:45:00,30571.9,2023-07-12 10:00:00,30704.1,132.2,549789.9800000014,449789.98000000144
2023-07-12 10:15:00,30685.9,2023-07-12 12:30:00,30767.6,-222.18,549567.8000000014,449567.80000000144
2023-07-12 23:15:00,30359.6,2023-07-13 03:00:00,30310.4,-49.2,549518.6000000015,449518.60000000143
2023-07-13 03:15:00,30266.3,2023-07-13 06:30:00,30336.1,-69.8,549448.8000000014,449448.80000000144
2023-07-13 06:45:00,30375.3,2023-07-13 16:15:00,30869.9,494.6,549943.4000000014,449943.4000000014
2023-07-13 16:30:00,30783.8,2023-07-13 17:45:00,31058.3,-274.5,549668.9000000014,449668.9000000014
2023-07-13 18:00:00,31389.9,2023-07-13 20:45:00,31364.9,-25.0,549643.9000000014,449643.9000000014
2023-07-13 21:00:00,31152.6,2023-07-13 23:15:00,31358.6,-206.0,549437.9000000014,449437.9000000014
2023-07-13 23:30:00,31468.2,2023-07-14 05:00:00,31384.8,-83.4,549354.5000000014,449354.5000000014
2023-07-14 05:15:00,31366.3,2023-07-14 14:30:00,31229.7,136.6,549491.1000000014,449491.1000000014
2023-07-14 14:45:00,31294.2,2023-07-14 16:45:00,31205.6,-88.6,549402.5000000014,449402.5000000014
2023-07-14 17:00:00,31087.1,2023-07-14 22:30:00,30215.0,872.1,550274.6000000014,450274.6000000014
2023-07-14 22:45:00,30208.0,2023-07-15 13:00:00,30300.3,92.3,550366.9000000013,450366.90000000136
2023-07-15 13:15:00,30287.4,2023-07-16 00:45:00,30289.9,-2.5,550364.4000000013,450364.40000000136
2023-07-16 01:00:00,30319.9,2023-07-16 02:00:00,30248.2,-77.44,550286.9600000014,450286.96000000136
2023-07-16 02:15:00,30104.6,2023-07-16 02:15:00,30104.6,0.0,550286.9600000014,450286.96000000136
2023-07-16 02:30:00,30293.5,2023-07-16 02:30:00,30293.5,-153.67,550133.2900000014,450133.2900000014
2023-07-16 04:15:00,30157.3,2023-07-16 06:15:00,30243.9,-86.6,550046.6900000013,450046.6900000014
2023-07-16 06:30:00,30261.6,2023-07-16 18:00:00,30364.5,102.9,550149.5900000015,450149.5900000014
2023-07-16 18:15:00,30314.2,2023-07-16 21:45:00,30274.9,39.3,550188.8900000014,450188.8900000014
2023-07-16 22:00:00,30330.1,2023-07-16 23:00:00,30295.4,-34.7,550154.1900000013,450154.1900000014
2023-07-16 23:15:00,30189.3,2023-07-17 01:15:00,30265.0,-75.7,550078.4900000014,450078.4900000014
2023-07-17 01:30:00,30300.0,2023-07-17 08:45:00,30242.7,-57.3,550021.1900000013,450021.1900000014
2023-07-17 09:00:00,30211.0,2023-07-17 10:30:00,30069.2,141.8,550162.9900000014,450162.9900000014
2023-07-17 10:45:00,30146.4,2023-07-17 16:45:00,30126.0,-20.4,550142.5900000014,450142.59000000136
2023-07-17 17:00:00,30013.0,2023-07-17 20:15:00,29917.9,95.1,550237.6900000013,450237.69000000134
2023-07-17 20:30:00,29922.1,2023-07-18 03:00:00,30137.4,215.3,550452.9900000014,450452.99000000133
2023-07-18 03:15:00,30101.6,2023-07-18 14:15:00,29921.3,180.3,550633.2900000013,450633.2900000013
2023-07-18 14:30:00,29968.1,2023-07-18 16:45:00,29688.0,-344.18,550289.1100000013,450289.1100000013
2023-07-19 06:30:00,30005.6,2023-07-19 11:30:00,29976.0,29.6,550318.7100000014,450318.7100000013
2023-07-19 11:45:00,30004.7,2023-07-19 13:15:00,29938.7,-183.15,550135.5600000012,450135.5600000013
2023-07-19 14:00:00,29879.4,2023-07-19 17:15:00,29953.3,-73.9,550061.6600000013,450061.66000000125
2023-07-19 17:30:00,29988.9,2023-07-19 22:15:00,29905.4,-83.5,549978.1600000013,449978.16000000125
2023-07-19 22:30:00,29851.1,2023-07-20 01:00:00,29985.9,-134.8,549843.3600000013,449843.36000000127
2023-07-20 01:15:00,29984.0,2023-07-20 12:15:00,30258.0,274.0,550117.3600000013,450117.36000000127
2023-07-20 12:30:00,30220.7,2023-07-20 20:45:00,29729.8,490.9,550608.2600000013,450608.2600000013
2023-07-20 21:00:00,29774.3,2023-07-21 05:30:00,29805.6,31.3,550639.5600000012,450639.5600000013
2023-07-21 05:45:00,29806.3,2023-07-21 12:15:00,29813.7,-7.4,550632.1600000013,450632.16000000125
2023-07-21 12:30:00,29846.3,2023-07-21 18:45:00,29970.0,123.7,550755.8600000013,450755.86000000127
2023-07-21 19:00:00,29791.3,2023-07-21 22:15:00,29900.2,-108.9,550646.9600000012,450646.96000000124
2023-07-21 22:30:00,29928.5,2023-07-22 04:30:00,29914.1,-14.4,550632.5600000012,450632.5600000012
2023-07-22 04:45:00,29870.9,2023-07-22 07:15:00,29907.8,-36.9,550595.6600000012,450595.6600000012
2023-07-22 07:30:00,29956.1,2023-07-22 09:45:00,29921.0,-35.1,550560.5600000012,450560.5600000012
2023-07-22 10:00:00,29896.0,2023-07-22 16:30:00,29884.4,11.6,550572.1600000012,450572.1600000012
2023-07-22 16:45:00,29888.2,2023-07-22 17:45:00,29824.0,-81.79,550490.3700000013,450490.3700000012
2023-07-22 18:00:00,29800.3,2023-07-22 23:30:00,29690.1,110.2,550600.5700000012,450600.57000000123
2023-07-22 23:45:00,29783.5,2023-07-23 10:15:00,29901.2,117.7,550718.2700000012,450718.27000000124
2023-07-23 10:30:00,29884.4,2023-07-23 15:45:00,29886.0,-1.6,550716.6700000013,450716.67000000126
2023-07-23 16:00:00,29926.0,2023-07-23 19:15:00,30178.1,252.1,550968.7700000012,450968.77000000124
2023-07-23 19:30:00,30073.1,2023-07-24 07:00:00,29742.4,330.7,551299.4700000013,451299.47000000125
2023-07-24 07:15:00,29798.1,2023-07-24 09:15:00,29726.0,-72.1,551227.3700000013,451227.3700000013
2023-07-24 09:30:00,29687.5,2023-07-24 09:45:00,29162.0,525.5,551752.8700000013,451752.8700000013
2023-07-24 10:00:00,29300.4,2023-07-24 14:00:00,29150.4,-150.0,551602.8700000013,451602.8700000013
2023-07-24 14:15:00,29078.1,2023-07-24 18:30:00,29073.0,5.1,551607.9700000013,451607.97000000125
2023-07-24 18:45:00,29114.4,2023-07-25 00:45:00,29103.3,-11.1,551596.8700000013,451596.8700000013
2023-07-25 01:00:00,29060.0,2023-07-25 06:00:00,29130.6,-70.6,551526.2700000013,451526.2700000013
2023-07-25 06:15:00,29135.3,2023-07-25 10:30:00,29166.1,30.8,551557.0700000012,451557.0700000013
2023-07-25 10:45:00,29151.6,2023-07-25 13:15:00,29134.9,16.7,551573.7700000013,451573.7700000013
2023-07-25 13:30:00,29317.7,2023-07-25 13:30:00,29317.7,-153.37,551420.4000000013,451420.4000000013
2023-07-25 19:30:00,29217.2,2023-07-26 02:30:00,29174.1,43.1,551463.5000000013,451463.5000000013
2023-07-26 02:45:00,29280.1,2023-07-26 03:00:00,29296.0,15.9,551479.4000000013,451479.4000000013
2023-07-26 03:15:00,29224.5,2023-07-26 12:00:00,29177.3,47.2,551526.6000000013,451526.6000000013
2023-07-26 12:15:00,29227.9,2023-07-26 23:00:00,29439.7,211.8,551738.4000000013,451738.4000000013
2023-07-26 23:15:00,29371.7,2023-07-27 04:00:00,29405.2,-33.5,551704.9000000013,451704.9000000013
2023-07-27 04:15:00,29435.0,2023-07-27 12:15:00,29467.1,32.1,551737.0000000013,451737.0000000013
2023-07-27 12:30:00,29445.1,2023-07-27 21:45:00,29169.5,275.6,552012.6000000013,452012.60000000126
2023-07-27 22:00:00,29215.0,2023-07-28 02:15:00,29217.6,2.6,552015.2000000012,452015.20000000123
2023-07-28 02:30:00,29176.3,2023-07-28 10:30:00,29191.4,-15.1,552000.1000000013,452000.10000000126
2023-07-28 10:45:00,29208.9,2023-07-28 15:45:00,29379.0,170.1,552170.2000000012,452170.20000000123
2023-07-28 16:00:00,29331.6,2023-07-28 20:30:00,29309.2,22.4,552192.6000000013,452192.60000000126
2023-07-28 20:45:00,29329.8,2023-07-29 05:45:00,29356.1,26.3,552218.9000000013,452218.90000000125
2023-07-29 06:00:00,29331.5,2023-07-29 16:30:00,29282.3,49.2,552268.1000000013,452268.10000000126
2023-07-29 16:45:00,29296.3,2023-07-30 01:15:00,29325.0,28.7,552296.8000000012,452296.80000000127
2023-07-30 01:30:00,29313.0,2023-07-30 08:00:00,29281.2,31.8,552328.6000000013,452328.60000000126
2023-07-30 08:15:00,29292.4,2023-07-30 10:45:00,29269.6,-48.13,552280.4700000013,452280.47000000125
2023-07-30 18:45:00,29342.1,2023-07-30 20:15:00,29149.2,192.9,552473.3700000013,452473.3700000013
2023-07-30 20:30:00,29181.6,2023-07-31 04:15:00,29392.4,210.8,552684.1700000013,452684.17000000126
2023-07-31 04:30:00,29385.8,2023-07-31 12:15:00,29397.6,-11.8,552672.3700000013,452672.3700000013
2023-07-31 12:30:00,29426.5,2023-07-31 13:45:00,29352.6,-116.01,552556.3600000013,452556.36000000127
2023-07-31 14:15:00,29327.9,2023-08-01 00:15:00,29229.9,98.0,552654.3600000013,452654.36000000127
2023-08-01 00:30:00,29250.8,2023-08-01 01:30:00,29234.3,-16.5,552637.8600000013,452637.86000000127
2023-08-01 01:45:00,29185.7,2023-08-01 02:00:00,28907.7,278.0,552915.8600000013,452915.86000000127
2023-08-01 02:15:00,28956.6,2023-08-01 11:00:00,28899.3,-57.3,552858.5600000012,452858.5600000013
2023-08-01 11:15:00,28885.0,2023-08-01 12:30:00,28889.1,-4.1,552854.4600000014,452854.4600000013
2023-08-01 12:45:00,28867.9,2023-08-01 15:30:00,28894.7,-224.5,552629.9600000014,452629.9600000013
2023-08-02 03:00:00,29766.0,2023-08-02 11:15:00,29497.5,268.5,552898.4600000014,452898.4600000013
2023-08-02 11:30:00,29548.4,2023-08-02 12:45:00,29451.1,-97.3,552801.1600000013,452801.1600000013
2023-08-02 13:00:00,29405.0,2023-08-02 19:00:00,29139.3,265.7,553066.8600000013,453066.8600000013
2023-08-02 19:15:00,29175.8,2023-08-03 04:00:00,29163.5,-12.3,553054.5600000013,453054.56000000134
2023-08-03 04:15:00,29128.9,2023-08-03 09:15:00,29102.5,26.4,553080.9600000014,453080.96000000136
2023-08-03 09:30:00,29123.7,2023-08-03 17:30:00,29237.0,113.3,553194.2600000014,453194.26000000135
2023-08-03 17:45:00,29215.7,2023-08-03 19:45:00,29265.7,-50.0,553144.2600000014,453144.26000000135
2023-08-03 20:00:00,29310.5,2023-08-03 22:00:00,29205.4,-105.1,553039.1600000013,453039.1600000014
2023-08-03 22:15:00,29173.3,2023-08-04 05:00:00,29187.5,-14.2,553024.9600000014,453024.96000000136
2023-08-04 05:15:00,29202.7,2023-08-04 10:30:00,29174.1,-28.6,552996.3600000014,452996.3600000014
2023-08-04 10:45:00,29152.8,2023-08-04 13:15:00,29206.1,-53.3,552943.0600000015,452943.0600000014
2023-08-04 13:30:00,29250.5,2023-08-04 17:15:00,29227.1,-23.4,552919.6600000013,452919.6600000014
2023-08-04 17:30:00,29197.1,2023-08-04 20:45:00,28952.1,245.0,553164.6600000013,453164.6600000014
2023-08-04 21:00:00,29074.3,2023-08-05 04:15:00,29059.0,-15.3,553149.3600000014,453149.3600000014
2023-08-05 04:30:00,29030.1,2023-08-05 13:45:00,29016.4,13.7,553163.0600000015,453163.0600000014
2023-08-05 14:00:00,29058.4,2023-08-05 23:45:00,29057.7,-0.7,553162.3600000014,453162.3600000014
2023-08-06 00:00:00,29048.0,2023-08-06 04:00:00,29056.8,-8.8,553153.5600000015,453153.5600000014
2023-08-06 04:15:00,29061.1,2023-08-06 06:00:00,29048.9,-12.2,553141.3600000014,453141.3600000014
2023-08-06 06:15:00,29053.1,2023-08-06 07:00:00,29060.6,-7.5,553133.8600000014,453133.8600000014
2023-08-06 07:15:00,29070.0,2023-08-06 08:45:00,29098.0,28.0,553161.8600000014,453161.8600000014
2023-08-06 09:00:00,29069.5,2023-08-06 16:15:00,29020.5,49.0,553210.8600000014,453210.8600000014
2023-08-06 16:30:00,29050.9,2023-08-06 21:30:00,29131.4,80.5,553291.3600000014,453291.3600000014
2023-08-06 21:45:00,29077.4,2023-08-07 01:00:00,29105.9,-28.5,553262.8600000014,453262.8600000014
2023-08-07 01:15:00,29167.9,2023-08-07 05:30:00,29119.1,-48.8,553214.0600000015,453214.0600000014
2023-08-07 05:45:00,29115.5,2023-08-07 10:15:00,29080.5,35.0,553249.0600000015,453249.0600000014
2023-08-07 10:30:00,29134.4,2023-08-07 12:00:00,29074.4,-60.0,553189.0600000015,453189.0600000014
2023-08-07 12:15:00,29027.2,2023-08-07 12:45:00,29070.2,-103.76,553085.3000000014,453085.3000000014
2023-08-07 16:45:00,28930.2,2023-08-08 04:45:00,29217.2,287.0,553372.3000000014,453372.3000000014
2023-08-08 06:45:00,29210.9,2023-08-08 10:15:00,29216.0,-5.1,553367.2000000014,453367.2000000014
2023-08-08 10:30:00,29255.2,2023-08-08 13:15:00,29481.1,225.9,553593.1000000015,453593.10000000143
2023-08-08 13:30:00,29364.7,2023-08-08 15:45:00,29517.5,-152.8,553440.3000000014,453440.30000000144
2023-08-08 16:00:00,29586.4,2023-08-08 21:15:00,29925.1,338.7,553779.0000000014,453779.00000000146
2023-08-08 21:30:00,29901.0,2023-08-09 07:00:00,29755.8,145.2,553924.2000000015,453924.20000000147
2023-08-09 07:15:00,29776.9,2023-08-09 13:15:00,29952.4,175.5,554099.7000000015,454099.70000000147
2023-08-09 13:30:00,29914.2,2023-08-09 22:00:00,29545.1,369.1,554468.8000000014,454468.80000000144
2023-08-09 22:15:00,29575.7,2023-08-10 04:45:00,29530.3,-45.4,554423.4000000014,454423.4000000014
2023-08-10 05:00:00,29514.7,2023-08-10 13:30:00,29588.2,-73.5,554349.9000000014,454349.9000000014
2023-08-10 13:45:00,29669.8,2023-08-10 14:15:00,29592.3,-77.5,554272.4000000014,454272.4000000014
2023-08-10 14:30:00,29413.8,2023-08-10 19:45:00,29435.5,-21.7,554250.7000000014,454250.7000000014
2023-08-10 20:00:00,29475.6,2023-08-11 02:00:00,29415.8,-59.8,554190.9000000014,454190.9000000014
2023-08-11 02:15:00,29406.4,2023-08-11 05:15:00,29398.3,8.1,554199.0000000014,454199.0000000014
2023-08-11 05:30:00,29424.1,2023-08-11 08:30:00,29415.8,-8.3,554190.7000000014,454190.7000000014
2023-08-11 08:45:00,29402.3,2023-08-11 11:15:00,29395.6,6.7,554197.4000000014,454197.4000000014
2023-08-11 11:30:00,29409.1,2023-08-11 14:45:00,29481.0,71.9,554269.3000000014,454269.30000000144
2023-08-11 15:00:00,29397.1,2023-08-11 19:00:00,29338.0,59.1,554328.4000000014,454328.4000000014
2023-08-11 19:15:00,29366.2,2023-08-12 02:30:00,29401.1,34.9,554363.3000000014,454363.30000000144
2023-08-12 02:45:00,29378.7,2023-08-12 06:30:00,29381.5,-2.8,554360.5000000014,454360.50000000146
2023-08-12 06:45:00,29410.7,2023-08-12 17:15:00,29444.2,33.5,554394.0000000014,454394.00000000146
2023-08-12 17:30:00,29432.6,2023-08-12 21:45:00,29411.5,21.1,554415.1000000015,454415.10000000143
2023-08-12 22:00:00,29418.0,2023-08-13 02:45:00,29434.6,16.6,554431.7000000014,454431.7000000014
2023-08-13 03:00:00,29391.7,2023-08-13 03:00:00,29391.7,-31.69,554400.0100000014,454400.0100000014
2023-08-13 06:00:00,29387.1,2023-08-13 11:00:00,29382.6,-4.5,554395.5100000014,454395.5100000014
2023-08-13 11:15:00,29382.2,2023-08-13 12:15:00,29374.8,7.4,554402.9100000014,454402.91000000143
2023-08-13 12:30:00,29381.2,2023-08-13 14:30:00,29373.2,-8.0,554394.9100000014,454394.91000000143
2023-08-13 14:45:00,29360.4,2023-08-13 16:45:00,29345.0,15.4,554410.3100000015,454410.31000000145
2023-08-13 17:00:00,29356.9,2023-08-13 19:45:00,29426.1,69.2,554479.5100000014,454479.51000000146
2023-08-13 20:00:00,29408.1,2023-08-14 02:15:00,29199.9,208.2,554687.7100000015,454687.7100000015
2023-08-14 02:30:00,29343.7,2023-08-14 09:15:00,29401.1,57.4,554745.1100000015,454745.1100000015
2023-08-14 09:30:00,29375.9,2023-08-14 13:45:00,29376.0,-0.1,554745.0100000015,454745.0100000015
2023-08-14 14:00:00,29421.1,2023-08-14 17:15:00,29543.9,122.8,554867.8100000015,454867.8100000015
2023-08-14 17:30:00,29504.2,2023-08-14 21:15:00,29376.0,128.2,554996.0100000015,454996.0100000015
2023-08-14 21:30:00,29394.5,2023-08-15 03:00:00,29380.6,-13.9,554982.1100000015,454982.1100000015
2023-08-15 03:15:00,29376.1,2023-08-15 08:00:00,29392.6,-16.5,554965.6100000015,454965.6100000015
2023-08-15 08:15:00,29415.1,2023-08-15 11:30:00,29382.7,-71.1,554894.5100000015,454894.5100000015
2023-08-15 11:45:00,29357.1,2023-08-15 14:30:00,29412.3,-55.2,554839.3100000015,454839.3100000015
2023-08-15 14:45:00,29442.6,2023-08-15 15:15:00,29374.7,-67.9,554771.4100000015,454771.4100000015
2023-08-15 15:30:00,29325.5,2023-08-15 20:00:00,29197.5,128.0,554899.4100000015,454899.4100000015
2023-08-15 20:15:00,29219.8,2023-08-16 05:00:00,29202.2,-17.6,554881.8100000015,454881.8100000015
2023-08-16 05:15:00,29183.0,2023-08-16 06:45:00,29180.8,2.2,554884.0100000015,454884.0100000015
2023-08-16 07:00:00,29187.8,2023-08-16 09:30:00,29153.1,-97.1,554786.9100000015,454786.91000000155
2023-08-16 12:15:00,29091.5,2023-08-16 14:45:00,29154.9,-63.4,554723.5100000015,454723.5100000015
2023-08-16 15:00:00,29169.5,2023-08-16 15:45:00,29098.0,-71.5,554652.0100000015,454652.0100000015
2023-08-16 16:00:00,29013.1,2023-08-16 17:00:00,29079.6,-66.5,554585.5100000015,454585.5100000015
2023-08-16 17:15:00,29137.0,2023-08-16 20:00:00,29129.1,-7.9,554577.6100000015,454577.6100000015
2023-08-16 20:15:00,28969.5,2023-08-17 01:30:00,28570.2,399.3,554976.9100000015,454976.9100000015
2023-08-17 01:45:00,28622.0,2023-08-17 08:30:00,28593.0,-29.0,554947.9100000015,454947.9100000015
2023-08-17 08:45:00,28545.3,2023-08-17 20:45:00,27589.63,955.67,555903.5800000015,455903.5800000015
2023-08-17 21:45:00,26249.9,2023-08-17 21:45:00,26249.9,-1275.68,554627.9000000015,454627.9000000015
2023-08-18 03:30:00,26396.5,2023-08-18 08:30:00,26453.0,-56.5,554571.4000000015,454571.4000000015
2023-08-18 08:45:00,26577.0,2023-08-18 12:30:00,26346.2,-230.8,554340.6000000015,454340.6000000015
2023-08-18 12:45:00,26318.0,2023-08-18 18:15:00,26036.3,281.7,554622.3000000014,454622.3000000015
2023-08-18 18:30:00,26161.1,2023-08-18 23:15:00,26015.4,-145.7,554476.6000000015,454476.6000000015
2023-08-18 23:30:00,26019.1,2023-08-19 08:00:00,25955.6,63.5,554540.1000000015,454540.1000000015
2023-08-19 08:15:00,25966.2,2023-08-19 17:45:00,26071.6,105.4,554645.5000000015,454645.5000000015
2023-08-19 18:00:00,26052.1,2023-08-20 00:15:00,26111.0,-58.9,554586.6000000015,454586.6000000015
2023-08-20 00:30:00,26162.9,2023-08-20 01:15:00,26081.7,-81.2,554505.4000000015,454505.4000000015
2023-08-20 01:30:00,26045.6,2023-08-20 05:00:00,26118.8,-73.2,554432.2000000015,454432.20000000147
2023-08-20 05:15:00,26134.1,2023-08-20 07:45:00,26073.6,-60.5,554371.7000000015,454371.70000000147
2023-08-20 08:00:00,26057.0,2023-08-20 09:30:00,26099.6,-42.6,554329.1000000015,454329.1000000015
2023-08-20 09:45:00,26130.0,2023-08-20 14:30:00,26098.8,-31.2,554297.9000000015,454297.9000000015
2023-08-20 14:45:00,26050.0,2023-08-20 17:15:00,26075.3,-25.3,554272.6000000015,454272.6000000015
2023-08-20 17:30:00,26118.9,2023-08-20 23:45:00,26175.9,57.0,554329.6000000015,454329.6000000015
2023-08-21 00:00:00,26120.4,2023-08-21 11:30:00,25988.0,132.4,554462.0000000015,454462.0000000015
2023-08-21 11:45:00,26020.7,2023-08-21 15:00:00,26025.7,5.0,554467.0000000015,454467.0000000015
2023-08-21 15:15:00,25853.0,2023-08-21 17:00:00,26000.8,-147.8,554319.2000000016,454319.2000000015
2023-08-21 17:15:00,26051.0,2023-08-21 23:00:00,26126.0,75.0,554394.2000000016,454394.2000000015
2023-08-21 23:15:00,26110.3,2023-08-22 07:15:00,26068.5,41.8,554436.0000000015,454436.0000000015
2023-08-22 07:30:00,26100.2,2023-08-22 10:45:00,26036.3,-63.9,554372.1000000015,454372.1000000015
2023-08-22 11:00:00,26020.5,2023-08-22 16:30:00,25968.8,51.7,554423.8000000014,454423.8000000015
2023-08-22 16:45:00,26008.2,2023-08-22 17:15:00,25927.6,-80.6,554343.2000000016,454343.2000000015
2023-08-22 17:30:00,25759.3,2023-08-22 21:15:00,25620.3,139.0,554482.2000000016,454482.2000000015
2023-08-22 21:30:00,25660.3,2023-08-23 03:45:00,25992.1,331.8,554814.0000000015,454814.0000000015
2023-08-23 04:00:00,25972.6,2023-08-23 06:45:00,26049.6,-175.05,554638.9500000016,454638.9500000015
2023-08-23 13:45:00,26003.9,2023-08-23 21:15:00,26558.0,554.1,555193.0500000014,455193.0500000015
2023-08-23 21:30:00,26483.3,2023-08-24 00:00:00,26454.4,28.9,555221.9500000016,455221.9500000015
2023-08-24 00:15:00,26476.3,2023-08-24 05:45:00,26411.9,-64.4,555157.5500000014,455157.5500000015
2023-08-24 06:00:00,26397.9,2023-08-24 08:45:00,26486.1,-88.2,555069.3500000015,455069.3500000015
2023-08-24 09:00:00,26533.2,2023-08-24 11:45:00,26433.8,-99.4,554969.9500000015,454969.95000000147
2023-08-24 12:00:00,26380.3,2023-08-24 19:00:00,26056.1,324.2,555294.1500000015,455294.1500000015
2023-08-24 19:15:00,26116.2,2023-08-25 03:00:00,26096.0,-20.2,555273.9500000015,455273.95000000147
2023-08-25 03:15:00,26042.6,2023-08-25 09:00:00,26074.9,-32.3,555241.6500000015,455241.6500000015
2023-08-25 09:15:00,26101.8,2023-08-25 13:30:00,26140.2,38.4,555280.0500000014,455280.0500000015
2023-08-25 13:45:00,26056.3,2023-08-25 14:15:00,26059.2,-201.88,555078.1700000016,455078.1700000015
2023-08-25 18:45:00,26038.9,2023-08-26 05:15:00,26049.2,10.3,555088.4700000015,455088.4700000015
2023-08-26 05:30:00,26040.3,2023-08-26 11:30:00,26035.1,5.2,555093.6700000016,455093.6700000015
2023-08-26 11:45:00,26035.9,2023-08-26 12:30:00,25990.1,-54.11,555039.5600000015,455039.5600000015
2023-08-26 16:30:00,26012.8,2023-08-27 03:15:00,26003.9,8.9,555048.4600000016,455048.46000000153
2023-08-27 03:30:00,26008.0,2023-08-27 12:00:00,26050.5,42.5,555090.9600000016,455090.96000000153
2023-08-27 12:15:00,26044.3,2023-08-27 13:45:00,26066.8,-22.5,555068.4600000016,455068.46000000153
2023-08-27 14:00:00,26120.1,2023-08-27 14:00:00,26120.1,-52.11,555016.3500000015,455016.35000000155
2023-08-27 17:45:00,26054.2,2023-08-27 18:45:00,26092.6,-38.4,554977.9500000016,454977.9500000015
2023-08-27 19:00:00,26123.9,2023-08-27 21:45:00,26058.6,-65.3,554912.6500000015,454912.65000000154
2023-08-27 22:00:00,26043.1,2023-08-28 05:45:00,25950.2,92.9,555005.5500000016,455005.55000000156
2023-08-28 06:00:00,25969.3,2023-08-28 18:15:00,26122.5,153.2,555158.7500000016,455158.7500000016
2023-08-28 18:30:00,26099.3,2023-08-28 22:15:00,26013.1,86.2,555244.9500000016,455244.9500000016
2023-08-28 22:30:00,26043.0,2023-08-29 02:45:00,26091.1,48.1,555293.0500000016,455293.05000000156
2023-08-29 03:00:00,26070.6,2023-08-29 12:30:00,26010.7,59.9,555352.9500000016,455352.9500000016
2023-08-29 12:45:00,26034.6,2023-08-29 14:15:00,27140.56,1105.96,556458.9100000015,456458.9100000016
2023-08-29 20:30:00,27712.1,2023-08-30 07:00:00,27410.5,301.6,556760.5100000016,456760.5100000016
2023-08-30 07:15:00,27450.9,2023-08-30 09:00:00,27429.9,-21.0,556739.5100000016,456739.5100000016
2023-08-30 09:15:00,27327.5,2023-08-30 13:30:00,27284.9,42.6,556782.1100000015,456782.11000000156
2023-08-30 13:45:00,27363.7,2023-08-30 14:45:00,27096.1,-324.8,556457.3100000016,456457.31000000157
2023-08-30 18:15:00,27120.8,2023-08-30 23:15:00,27293.4,-172.6,556284.7100000016,456284.7100000016
2023-08-30 23:30:00,27295.8,2023-08-31 03:00:00,27198.7,-97.1,556187.6100000016,456187.6100000016
2023-08-31 03:15:00,27175.1,2023-08-31 06:45:00,27244.5,-104.38,556083.2300000016,456083.2300000016
2023-08-31 07:15:00,27278.2,2023-08-31 10:30:00,27200.2,-78.0,556005.2300000016,456005.2300000016
2023-08-31 10:45:00,27190.3,2023-08-31 11:15:00,27289.9,-112.75,555892.4800000016,455892.4800000016
2023-08-31 11:30:00,27456.8,2023-08-31 11:30:00,27456.8,0.0,555892.4800000016,455892.4800000016
2023-08-31 11:45:00,27291.8,2023-08-31 18:45:00,26183.94,1107.86,557000.3400000016,457000.3400000016
2023-08-31 22:45:00,26042.8,2023-09-01 07:30:00,25977.6,-65.2,556935.1400000015,456935.1400000016
2023-09-01 07:45:00,25975.2,2023-09-01 11:45:00,26033.7,-58.5,556876.6400000015,456876.6400000016
2023-09-01 12:00:00,26072.7,2023-09-01 12:15:00,26057.1,-15.6,556861.0400000017,456861.0400000016
2023-09-01 12:30:00,25993.6,2023-09-01 15:00:00,25779.5,214.1,557075.1400000015,457075.1400000016
2023-09-01 15:15:00,25852.3,2023-09-01 16:45:00,25779.9,-72.4,557002.7400000016,457002.74000000156
2023-09-01 17:00:00,25614.2,2023-09-01 20:00:00,25630.5,-16.3,556986.4400000016,456986.4400000016
2023-09-01 20:15:00,25727.5,2023-09-02 02:30:00,25773.8,46.3,557032.7400000016,457032.74000000156
2023-09-02 02:45:00,25749.6,2023-09-02 10:15:00,25809.3,-59.7,556973.0400000016,456973.04000000155
2023-09-02 10:30:00,25827.0,2023-09-02 16:45:00,25851.3,24.3,556997.3400000015,456997.34000000154
2023-09-02 17:00:00,25840.4,2023-09-02 20:45:00,25839.5,0.9,556998.2400000016,456998.24000000156
2023-09-02 21:00:00,25848.6,2023-09-03 12:30:00,26014.6,166.0,557164.2400000016,457164.24000000156
2023-09-03 12:45:00,25883.4,2023-09-03 12:45:00,25883.4,-138.89,557025.3500000015,457025.35000000155
2023-09-03 18:30:00,25956.6,2023-09-03 21:30:00,25971.4,14.8,557040.1500000015,457040.15000000154
2023-09-03 21:45:00,25956.0,2023-09-04 02:45:00,25970.8,-14.8,557025.3500000015,457025.35000000155
2023-09-04 03:00:00,26028.2,2023-09-04 04:30:00,25988.6,-39.6,556985.7500000016,456985.7500000016
2023-09-04 04:45:00,25969.7,2023-09-04 16:45:00,25852.1,117.6,557103.3500000015,457103.35000000155
2023-09-04 17:00:00,25906.4,2023-09-04 20:45:00,25823.1,-83.3,557020.0500000016,457020.05000000156
2023-09-04 21:00:00,25758.4,2023-09-04 23:15:00,25770.5,-12.1,557007.9500000016,457007.9500000016
2023-09-04 23:30:00,25803.8,2023-09-05 02:15:00,25722.2,-81.6,556926.3500000016,456926.3500000016
2023-09-05 02:30:00,25698.2,2023-09-05 03:45:00,25681.8,16.4,556942.7500000016,456942.75000000163
2023-09-05 04:00:00,25696.7,2023-09-05 08:15:00,25689.0,-7.7,556935.0500000017,456935.0500000016
2023-09-05 08:30:00,25657.1,2023-09-05 10:00:00,25770.8,-113.7,556821.3500000016,456821.3500000016
2023-09-05 10:15:00,25781.5,2023-09-05 14:15:00,25687.8,-93.7,556727.6500000015,456727.6500000016
2023-09-05 14:30:00,25665.6,2023-09-05 14:45:00,25702.2,-36.6,556691.0500000017,456691.0500000016
2023-09-05 15:00:00,25813.5,2023-09-05 18:00:00,25723.3,-90.2,556600.8500000016,456600.8500000016
2023-09-05 18:15:00,25705.1,2023-09-05 23:00:00,25762.9,-57.8,556543.0500000017,456543.0500000016
2023-09-05 23:15:00,25773.2,2023-09-06 03:45:00,25770.1,-3.1,556539.9500000016,456539.95000000164
2023-09-06 04:00:00,25760.6,2023-09-06 17:00:00,25508.8,251.8,556791.7500000016,456791.75000000163
2023-09-06 17:15:00,25612.9,2023-09-06 18:00:00,25803.3,190.4,556982.1500000017,456982.15000000165
2023-09-06 18:15:00,25679.9,2023-09-06 23:00:00,25756.2,-76.3,556905.8500000017,456905.85000000166
2023-09-06 23:15:00,25768.9,2023-09-07 07:00:00,25747.3,-21.6,556884.2500000016,456884.2500000017
2023-09-07 07:15:00,25738.6,2023-09-07 14:30:00,25729.6,9.0,556893.2500000016,456893.2500000017
2023-09-07 14:45:00,25760.0,2023-09-07 21:30:00,26174.6,414.6,557307.8500000017,457307.85000000166
2023-09-07 21:45:00,26149.5,2023-09-08 04:15:00,26267.1,-117.6,557190.2500000016,457190.2500000017
2023-09-08 04:30:00,26337.6,2023-09-08 07:45:00,26244.1,-93.5,557096.7500000016,457096.7500000017
2023-09-08 08:00:00,26200.9,2023-09-08 12:00:00,25822.8,378.1,557474.8500000017,457474.85000000166
2023-09-08 12:15:00,25855.2,2023-09-08 16:15:00,25821.8,-33.4,557441.4500000016,457441.45000000164
2023-09-08 16:30:00,25745.3,2023-09-08 19:15:00,25831.6,-86.3,557355.1500000017,457355.15000000165
2023-09-08 19:30:00,25873.3,2023-09-09 03:45:00,25866.2,-7.1,557348.0500000017,457348.0500000017
2023-09-09 04:00:00,25854.8,2023-09-09 06:45:00,25870.7,-15.9,557332.1500000017,457332.15000000165
2023-09-09 07:00:00,25873.3,2023-09-09 11:45:00,25850.8,-22.5,557309.6500000017,457309.65000000165
2023-09-09 12:00:00,25846.8,2023-09-09 14:45:00,25833.2,13.6,557323.2500000016,457323.25000000163
2023-09-09 15:00:00,25865.4,2023-09-09 17:45:00,25868.4,3.0,557326.2500000016,457326.25000000163
2023-09-09 18:00:00,25851.9,2023-09-10 04:30:00,25789.8,62.1,557388.3500000016,457388.3500000016
2023-09-10 04:45:00,25821.5,2023-09-10 10:15:00,25816.6,-4.9,557383.4500000016,457383.4500000016
2023-09-10 10:30:00,25799.1,2023-09-10 19:30:00,25711.7,87.4,557470.8500000016,457470.8500000016
2023-09-10 19:45:00,25786.7,2023-09-10 22:30:00,25876.1,89.4,557560.2500000016,457560.25000000163
2023-09-10 22:45:00,25838.3,2023-09-11 04:30:00,25748.3,90.0,557650.2500000016,457650.25000000163
2023-09-11 04:45:00,25768.1,2023-09-11 08:00:00,25776.0,7.9,557658.1500000017,457658.15000000165
2023-09-11 08:15:00,25752.1,2023-09-11 20:45:00,25086.2,665.9,558324.0500000017,458324.0500000017
2023-09-11 21:00:00,25177.3,2023-09-12 05:00:00,25674.3,497.0,558821.0500000017,458821.0500000017
2023-09-12 05:15:00,25631.5,2023-09-12 09:30:00,25808.4,-176.9,558644.1500000017,458644.15000000165
2023-09-12 09:45:00,25860.9,2023-09-12 16:30:00,26223.5,362.6,559006.7500000016,459006.75000000163
2023-09-12 16:45:00,26094.4,2023-09-13 06:00:00,25881.3,213.1,559219.8500000016,459219.8500000016
2023-09-13 06:15:00,25909.4,2023-09-13 07:30:00,25934.8,25.4,559245.2500000016,459245.25000000163
2023-09-13 07:45:00,25865.7,2023-09-13 09:15:00,26010.1,-144.4,559100.8500000016,459100.8500000016
2023-09-13 09:30:00,26070.3,2023-09-13 18:30:00,26128.6,58.3,559159.1500000015,459159.1500000016
2023-09-13 18:45:00,26098.7,2023-09-13 21:45:00,26214.1,-115.4,559043.7500000016,459043.7500000016
2023-09-13 22:00:00,26249.0,2023-09-14 01:00:00,26342.3,93.3,559137.0500000016,459137.05000000156
2023-09-14 01:15:00,26199.9,2023-09-14 06:30:00,26246.8,-46.9,559090.1500000015,459090.15000000154
2023-09-14 06:45:00,26280.8,2023-09-14 18:30:00,26659.0,378.2,559468.3500000015,459468.35000000155
2023-09-14 18:45:00,26568.1,2023-09-15 02:30:00,26590.4,-22.3,559446.0500000016,459446.05000000156
2023-09-15 02:45:00,26596.1,2023-09-15 07:45:00,26554.4,-41.7,559404.3500000015,459404.35000000155
2023-09-15 08:00:00,26531.9,2023-09-15 09:00:00,26595.2,-122.73,559281.6200000015,459281.62000000157
2023-09-15 19:00:00,26390.4,2023-09-15 23:15:00,26659.0,268.6,559550.2200000016,459550.22000000154
2023-09-15 23:30:00,26651.4,2023-09-16 13:45:00,26535.9,115.5,559665.7200000016,459665.72000000154
2023-09-16 14:00:00,26546.1,2023-09-16 23:00:00,26552.9,6.8,559672.5200000015,459672.52000000153
2023-09-16 23:15:00,26518.7,2023-09-17 02:15:00,26487.1,31.6,559704.1200000015,459704.1200000015
2023-09-17 02:30:00,26502.0,2023-09-17 07:30:00,26507.8,5.8,559709.9200000016,459709.9200000015
2023-09-17 07:45:00,26482.6,2023-09-17 09:00:00,26534.9,-68.9,559641.0200000014,459641.0200000015
2023-09-17 09:45:00,26564.7,2023-09-17 13:15:00,26557.0,-7.7,559633.3200000015,459633.32000000146
2023-09-17 13:30:00,26544.4,2023-09-17 21:15:00,26440.9,103.5,559736.8200000015,459736.82000000146
2023-09-17 21:30:00,26482.5,2023-09-18 12:30:00,27360.78,878.28,560615.1000000015,460615.1000000015
2023-09-18 17:15:00,26890.3,2023-09-18 17:15:00,26890.3,-298.03,560317.0700000015,460317.07000000146
2023-09-18 22:45:00,26859.0,2023-09-19 00:30:00,26705.9,-205.22,560111.8500000015,460111.8500000015
2023-09-19 00:45:00,26666.7,2023-09-19 03:15:00,26778.1,-111.4,560000.4500000015,460000.45000000147
2023-09-19 03:30:00,26817.6,2023-09-19 09:45:00,27278.6,461.0,560461.4500000015,460461.45000000147
2023-09-19 10:00:00,27199.2,2023-09-19 15:00:00,27209.3,-10.1,560451.3500000015,460451.3500000015
2023-09-19 15:15:00,27315.9,2023-09-19 18:15:00,27115.1,-200.8,560250.5500000014,460250.5500000015
2023-09-19 18:30:00,27098.9,2023-09-19 23:30:00,27191.2,-92.3,560158.2500000015,460158.2500000015
2023-09-19 23:45:00,27196.0,2023-09-20 03:00:00,27184.6,-11.4,560146.8500000015,460146.8500000015
2023-09-20 03:15:00,27120.1,2023-09-20 08:00:00,27100.1,20.0,560166.8500000015,460166.8500000015
2023-09-20 08:15:00,27126.4,2023-09-20 09:45:00,27041.4,-187.49,559979.3600000015,459979.3600000015
2023-09-20 10:00:00,26970.2,2023-09-20 13:30:00,27085.2,-115.0,559864.3600000015,459864.3600000015
2023-09-20 13:45:00,27146.6,2023-09-20 19:00:00,27085.3,-61.3,559803.0600000015,459803.0600000015
2023-09-20 19:15:00,26927.9,2023-09-20 20:30:00,26996.9,-69.0,559734.0600000015,459734.0600000015
2023-09-20 20:45:00,27085.8,2023-09-21 00:45:00,27033.0,-52.8,559681.2600000015,459681.2600000015
2023-09-21 01:00:00,26994.0,2023-09-21 05:15:00,27029.1,-35.1,559646.1600000015,459646.16000000155
2023-09-21 05:30:00,27073.8,2023-09-21 08:30:00,26968.0,-138.25,559507.9100000015,459507.91000000155
2023-09-21 08:45:00,26916.7,2023-09-21 16:45:00,26567.3,349.4,559857.3100000016,459857.31000000157
2023-09-21 17:00:00,26660.0,2023-09-21 20:15:00,26532.3,-175.83,559681.4800000016,459681.48000000155
2023-09-21 23:30:00,26547.1,2023-09-22 00:30:00,26609.9,-62.8,559618.6800000016,459618.68000000156
2023-09-22 00:45:00,26629.2,2023-09-22 10:00:00,26638.9,9.7,559628.3800000015,459628.3800000016
2023-09-22 10:15:00,26600.0,2023-09-22 23:15:00,26567.7,32.3,559660.6800000016,459660.68000000156
2023-09-22 23:30:00,26584.5,2023-09-23 04:00:00,26525.5,-88.78,559571.9000000015,459571.90000000154
2023-09-23 05:45:00,26529.9,2023-09-23 12:00:00,26562.5,-32.6,559539.3000000016,459539.30000000156
2023-09-23 12:15:00,26568.8,2023-09-23 20:30:00,26576.4,7.6,559546.9000000015,459546.90000000154
2023-09-23 20:45:00,26572.6,2023-09-24 08:00:00,26556.0,16.6,559563.5000000015,459563.5000000015
2023-09-24 08:15:00,26565.9,2023-09-24 10:15:00,26571.4,5.5,559569.0000000015,459569.0000000015
2023-09-24 10:30:00,26565.3,2023-09-24 13:00:00,26585.0,-40.55,559528.4500000016,459528.4500000015
2023-09-24 17:45:00,26661.3,2023-09-24 17:45:00,26661.3,-66.81,559461.6400000015,459461.6400000015
2023-09-24 18:15:00,26543.9,2023-09-24 18:15:00,26543.9,0.0,559461.6400000015,459461.6400000015
2023-09-24 18:30:00,26597.8,2023-09-24 19:00:00,26517.0,-80.8,559380.8400000015,459380.84000000154
2023-09-24 19:15:00,26425.8,2023-09-24 20:30:00,26456.5,-30.7,559350.1400000015,459350.1400000015
2023-09-24 20:45:00,26489.3,2023-09-24 23:00:00,26425.0,-64.3,559285.8400000015,459285.84000000154
2023-09-24 23:15:00,26228.0,2023-09-25 00:30:00,26120.3,107.7,559393.5400000016,459393.54000000155
2023-09-25 00:45:00,26239.5,2023-09-25 04:15:00,26164.8,-74.7,559318.8400000015,459318.84000000154
2023-09-25 04:30:00,26101.3,2023-09-25 13:00:00,26118.2,-16.9,559301.9400000016,459301.9400000015
2023-09-25 13:15:00,26142.8,2023-09-25 21:30:00,26261.8,119.0,559420.9400000016,459420.9400000015
2023-09-25 21:45:00,26267.8,2023-09-26 02:30:00,26306.2,-38.4,559382.5400000014,459382.5400000015
2023-09-26 02:45:00,26343.0,2023-09-26 06:00:00,26297.2,-45.8,559336.7400000015,459336.7400000015
2023-09-26 06:15:00,26278.6,2023-09-26 16:15:00,26220.0,58.6,559395.3400000015,459395.3400000015
2023-09-26 16:30:00,26253.3,2023-09-26 21:15:00,26138.7,-163.2,559232.1400000015,459232.14000000147
2023-09-26 22:45:00,26145.1,2023-09-27 02:00:00,26237.5,-92.4,559139.7400000014,459139.74000000145
2023-09-27 02:15:00,26266.2,2023-09-27 13:45:00,26607.9,341.7,559481.4400000015,459481.44000000146
2023-09-27 14:00:00,26558.4,2023-09-27 19:30:00,26247.5,310.9,559792.3400000015,459792.3400000015
2023-09-27 19:45:00,26258.6,2023-09-28 02:45:00,26371.9,113.3,559905.6400000015,459905.64000000147
2023-09-28 03:00:00,26341.7,2023-09-28 07:45:00,26445.7,-152.54,559753.1000000015,459753.1000000015
2023-09-28 10:30:00,26545.4,2023-09-28 18:30:00,27013.4,468.0,560221.1000000015,460221.1000000015
2023-09-28 18:45:00,26949.0,2023-09-29 00:00:00,27059.1,-110.1,560111.0000000015,460111.0000000015
2023-09-29 00:15:00,27078.1,2023-09-29 02:30:00,26902.1,-176.0,559935.0000000015,459935.0000000015
2023-09-29 02:45:00,26879.5,2023-09-29 06:30:00,26998.0,-118.5,559816.5000000015,459816.5000000015
2023-09-29 06:45:00,27060.7,2023-09-29 08:15:00,27093.7,33.0,559849.5000000015,459849.5000000015
2023-09-29 08:30:00,27039.4,2023-09-29 14:15:00,26765.7,273.7,560123.2000000016,460123.2000000015
2023-09-29 14:30:00,26988.9,2023-09-29 16:15:00,26852.6,-136.3,559986.9000000015,459986.90000000154
2023-09-29 16:30:00,26807.6,2023-09-29 21:00:00,26884.8,-77.2,559909.7000000016,459909.7000000015
2023-09-29 21:15:00,26909.7,2023-09-30 11:15:00,26960.4,50.7,559960.4000000015,459960.40000000154
2023-09-30 11:30:00,26912.6,2023-09-30 13:45:00,26962.0,-49.4,559911.0000000015,459911.0000000015
2023-09-30 14:00:00,26985.5,2023-09-30 18:15:00,26999.1,13.6,559924.6000000015,459924.6000000015
2023-09-30 18:30:00,26981.4,2023-09-30 20:45:00,27049.0,-67.6,559857.0000000015,459857.0000000015
2023-09-30 21:00:00,27063.9,2023-09-30 21:30:00,26987.0,-103.54,559753.4600000016,459753.46000000153
2023-09-30 23:15:00,26950.0,2023-10-01 03:00:00,27003.1,-53.1,559700.3600000015,459700.36000000156
2023-10-01 03:15:00,27029.9,2023-10-01 11:45:00,27174.2,144.3,559844.6600000015,459844.66000000155
2023-10-01 12:00:00,27132.9,2023-10-01 21:15:00,27119.8,13.1,559857.7600000015,459857.7600000015
2023-10-01 21:30:00,27143.9,2023-10-01 22:15:00,28261.47,1117.57,560975.3300000015,460975.33000000153
2023-10-01 22:30:00,27933.0,2023-10-02 03:30:00,28089.5,-294.03,560681.3000000014,460681.3000000015
2023-10-02 03:45:00,28114.8,2023-10-02 11:30:00,28234.8,120.0,560801.3000000014,460801.3000000015
2023-10-02 11:45:00,28183.2,2023-10-02 13:30:00,28410.9,-270.3,560531.0000000015,460531.0000000015
2023-10-02 13:45:00,28540.0,2023-10-02 14:15:00,28287.9,-364.77,560166.2300000015,460166.2300000015
2023-10-02 15:45:00,28015.0,2023-10-03 02:00:00,27535.1,479.9,560646.1300000015,460646.1300000015
2023-10-03 02:15:00,27544.4,2023-10-03 11:00:00,27519.8,-24.6,560621.5300000015,460621.53000000154
2023-10-03 11:15:00,27471.5,2023-10-03 20:30:00,27338.4,133.1,560754.6300000015,460754.6300000015
2023-10-03 20:45:00,27384.5,2023-10-04 13:30:00,27472.1,87.6,560842.2300000015,460842.2300000015
2023-10-04 13:45:00,27404.6,2023-10-04 16:45:00,27509.5,-104.9,560737.3300000015,460737.3300000015
2023-10-04 17:00:00,27546.3,2023-10-05 02:00:00,27691.1,144.8,560882.1300000015,460882.13000000146
2023-10-05 02:15:00,27668.2,2023-10-05 08:45:00,27634.1,34.1,560916.2300000014,460916.23000000144
2023-10-05 09:00:00,27660.5,2023-10-05 14:45:00,27946.3,285.8,561202.0300000014,461202.0300000014
2023-10-05 15:00:00,27770.1,2023-10-06 01:15:00,27477.9,292.2,561494.2300000014,461494.23000000144
2023-10-06 01:30:00,27506.4,2023-10-06 12:15:00,27672.4,166.0,561660.2300000014,461660.23000000144
2023-10-06 12:30:00,27517.9,2023-10-06 13:30:00,27490.1,27.8,561688.0300000014,461688.0300000014
2023-10-06 13:45:00,27513.7,2023-10-06 21:30:00,28094.6,580.9,562268.9300000014,462268.93000000145
2023-10-06 21:45:00,28030.2,2023-10-07 08:15:00,27907.0,123.2,562392.1300000015,462392.13000000146
2023-10-07 08:30:00,27990.7,2023-10-07 13:15:00,27935.4,-55.3,562336.8300000015,462336.8300000015
2023-10-07 13:30:00,27886.5,2023-10-07 21:15:00,27926.5,-40.0,562296.8300000015,462296.8300000015
2023-10-07 21:30:00,27937.7,2023-10-08 03:45:00,28049.9,112.2,562409.0300000014,462409.0300000015
2023-10-08 04:00:00,27948.3,2023-10-08 13:15:00,27860.6,87.7,562496.7300000015,462496.7300000015
2023-10-08 13:30:00,27893.6,2023-10-08 17:45:00,27862.9,-30.7,562466.0300000014,462466.0300000015
2023-10-08 18:00:00,27843.5,2023-10-08 20:45:00,27892.8,-49.3,562416.7300000015,462416.7300000015
2023-10-08 21:00:00,27930.0,2023-10-08 21:45:00,27904.0,-26.0,562390.7300000015,462390.7300000015
2023-10-08 22:00:00,27811.7,2023-10-09 01:30:00,27871.9,-60.2,562330.5300000014,462330.5300000015
2023-10-09 01:45:00,27948.4,2023-10-09 05:00:00,27910.4,-38.0,562292.5300000014,462292.5300000015
2023-10-09 05:15:00,27870.4,2023-10-09 17:30:00,27483.3,387.1,562679.6300000015,462679.63000000146
2023-10-09 17:45:00,27582.6,2023-10-09 23:00:00,27591.9,9.3,562688.9300000014,462688.93000000145
2023-10-09 23:15:00,27564.2,2023-10-10 02:30:00,27613.0,-48.8,562640.1300000015,462640.13000000146
2023-10-10 02:45:00,27668.2,2023-10-10 04:45:00,27584.5,-83.7,562556.4300000014,462556.43000000145
2023-10-10 05:00:00,27567.5,2023-10-10 06:45:00,27638.0,-70.5,562485.9300000014,462485.93000000145
2023-10-10 07:00:00,27677.9,2023-10-10 10:30:00,27624.9,-53.0,562432.9300000014,462432.93000000145
2023-10-10 10:45:00,27596.9,2023-10-10 13:45:00,27384.8,212.1,562645.0300000014,462645.0300000014
2023-10-10 14:00:00,27537.5,2023-10-10 17:30:00,27385.2,-152.3,562492.7300000014,462492.73000000144
2023-10-10 17:45:00,27356.9,2023-10-10 22:30:00,27440.8,-83.9,562408.8300000015,462408.8300000014
2023-10-10 22:45:00,27434.9,2023-10-11 02:15:00,27348.7,-86.2,562322.6300000014,462322.6300000014
2023-10-11 02:30:00,27136.5,2023-10-11 02:30:00,27136.5,-186.52,562136.1100000014,462136.1100000014
2023-10-11 09:00:00,27132.7,2023-10-11 12:45:00,27157.9,25.2,562161.3100000015,462161.3100000014
2023-10-11 13:00:00,27105.7,2023-10-11 21:45:00,26721.5,384.2,562545.5100000014,462545.5100000014
2023-10-11 22:00:00,26730.1,2023-10-12 04:30:00,26826.2,96.1,562641.6100000014,462641.6100000014
2023-10-12 04:45:00,26809.4,2023-10-12 06:15:00,26878.4,-69.0,562572.6100000014,462572.6100000014
2023-10-12 06:30:00,26900.4,2023-10-12 07:45:00,26799.4,-101.0,562471.6100000014,462471.6100000014
2023-10-12 08:00:00,26769.2,2023-10-12 11:30:00,26774.6,-5.4,562466.2100000014,462466.21000000136
2023-10-12 11:45:00,26827.4,2023-10-12 14:15:00,26677.1,-150.3,562315.9100000013,462315.9100000014
2023-10-12 14:30:00,26660.0,2023-10-12 19:45:00,26700.3,-40.3,562275.6100000014,462275.6100000014
2023-10-12 20:00:00,26734.0,2023-10-13 05:15:00,26788.9,54.9,562330.5100000014,462330.5100000014
2023-10-13 05:30:00,26781.3,2023-10-13 07:15:00,26872.9,-107.27,562223.2400000014,462223.2400000014
2023-10-13 12:15:00,26847.4,2023-10-13 13:45:00,26843.0,-4.4,562218.8400000014,462218.84000000136
2023-10-13 14:00:00,26802.3,2023-10-13 20:30:00,26759.3,43.0,562261.8400000014,462261.84000000136
2023-10-13 20:45:00,26967.8,2023-10-13 20:45:00,26967.8,-191.58,562070.2600000014,462070.26000000135
2023-10-13 22:45:00,26813.9,2023-10-14 02:45:00,26889.7,-75.8,561994.4600000014,461994.46000000136
2023-10-14 03:00:00,26909.8,2023-10-14 05:30:00,26885.7,-24.1,561970.3600000014,461970.3600000014
2023-10-14 05:45:00,26874.2,2023-10-14 13:15:00,26871.0,3.2,561973.5600000015,461973.5600000014
2023-10-14 13:30:00,26896.6,2023-10-14 17:45:00,26875.1,-21.5,561952.0600000015,461952.0600000014
2023-10-14 18:00:00,26862.9,2023-10-14 22:45:00,26832.7,30.2,561982.2600000014,461982.2600000014
2023-10-14 23:00:00,26847.7,2023-10-15 07:15:00,26864.9,17.2,561999.4600000014,461999.4600000014
2023-10-15 07:30:00,26863.3,2023-10-15 08:30:00,26896.9,-35.65,561963.8100000015,461963.8100000014
2023-10-15 09:00:00,26905.7,2023-10-15 10:45:00,26880.9,-24.8,561939.0100000014,461939.0100000014
2023-10-15 11:00:00,26847.5,2023-10-15 13:00:00,26867.9,-20.4,561918.6100000014,461918.6100000014
2023-10-15 13:15:00,26915.0,2023-10-15 13:15:00,26915.0,0.0,561918.6100000014,461918.6100000014
2023-10-15 13:30:00,26870.0,2023-10-15 16:15:00,26895.9,-25.9,561892.7100000014,461892.71000000136
2023-10-15 16:30:00,26913.9,2023-10-15 20:30:00,27174.4,260.5,562153.2100000014,462153.21000000136
2023-10-15 20:45:00,27193.9,2023-10-16 01:00:00,27184.4,9.5,562162.7100000014,462162.71000000136
2023-10-16 01:15:00,27227.0,2023-10-16 06:30:00,27849.3,622.3,562785.0100000014,462785.01000000135
2023-10-16 06:45:00,27800.0,2023-10-16 12:30:00,27775.0,25.0,562810.0100000014,462810.01000000135
2023-10-16 12:45:00,27873.3,2023-10-16 13:30:00,28232.1,358.8,563168.8100000013,463168.81000000134
2023-10-16 13:45:00,27986.5,2023-10-16 17:45:00,28219.0,-232.5,562936.3100000013,462936.31000000134
2023-10-16 18:00:00,28360.6,2023-10-17 00:00:00,28447.4,86.8,563023.1100000013,463023.1100000013
2023-10-17 00:15:00,28331.0,2023-10-17 07:15:00,28207.6,123.4,563146.5100000014,463146.51000000135
2023-10-17 07:30:00,28321.6,2023-10-17 12:15:00,28398.5,76.9,563223.4100000013,463223.4100000014
2023-10-17 12:30:00,28340.3,2023-10-17 14:30:00,28412.2,-71.9,563151.5100000014,463151.51000000135
2023-10-17 14:45:00,28449.7,2023-10-17 23:15:00,28420.6,-29.1,563122.4100000013,463122.4100000014
2023-10-17 23:30:00,28401.1,2023-10-18 03:15:00,28463.0,-61.9,563060.5100000014,463060.51000000135
2023-10-18 03:30:00,28485.2,2023-10-18 04:45:00,28716.8,231.6,563292.1100000013,463292.1100000013
2023-10-18 05:00:00,28660.1,2023-10-18 16:45:00,28332.1,328.0,563620.1100000013,463620.1100000013
2023-10-18 17:00:00,28390.5,2023-10-18 20:30:00,28219.6,-207.44,563412.6700000013,463412.6700000013
2023-10-19 01:30:00,28108.5,2023-10-19 01:30:00,28108.5,-206.58,563206.0900000012,463206.0900000013
2023-10-19 04:30:00,28263.6,2023-10-19 17:15:00,28616.6,353.0,563559.0900000012,463559.0900000013
2023-10-19 17:30:00,28484.6,2023-10-19 19:15:00,28695.7,-211.1,563347.9900000014,463347.99000000133
2023-10-19 19:30:00,28715.3,2023-10-19 21:30:00,28629.7,-85.6,563262.3900000013,463262.39000000135
2023-10-19 21:45:00,28590.0,2023-10-20 02:00:00,28677.8,-87.8,563174.5900000014,463174.59000000136
2023-10-20 02:15:00,28763.0,2023-10-20 12:00:00,29867.8,1104.8,564279.3900000013,464279.39000000135
2023-10-20 12:15:00,29588.7,2023-10-20 20:15:00,29566.3,22.4,564301.7900000014,464301.7900000014
2023-10-20 20:30:00,29607.6,2023-10-21 01:00:00,29606.0,-1.6,564300.1900000013,464300.1900000014
2023-10-21 01:15:00,29579.3,2023-10-21 03:45:00,29591.0,-11.7,564288.4900000014,464288.4900000014
2023-10-21 04:00:00,29614.9,2023-10-21 20:00:00,30073.4,458.5,564746.9900000014,464746.9900000014
2023-10-21 20:15:00,29999.6,2023-10-22 00:45:00,29957.9,41.7,564788.6900000013,464788.6900000014
2023-10-22 01:00:00,30052.9,2023-10-22 02:00:00,29870.0,-182.9,564605.7900000014,464605.7900000014
2023-10-22 02:15:00,29843.0,2023-10-22 05:00:00,29985.0,-179.02,564426.7700000014,464426.77000000136
2023-10-22 05:45:00,30103.3,2023-10-22 06:45:00,30062.1,-41.2,564385.5700000013,464385.57000000135
2023-10-22 07:00:00,29961.9,2023-10-22 08:45:00,29817.3,144.6,564530.1700000013,464530.1700000013
2023-10-22 09:00:00,29951.6,2023-10-22 19:30:00,29876.0,-75.6,564454.5700000013,464454.57000000135
2023-10-22 19:45:00,29830.0,2023-10-22 22:15:00,29821.0,9.0,564463.5700000013,464463.57000000135
2023-10-22 22:30:00,29955.9,2023-10-23 01:45:00,30336.6,380.7,564844.2700000014,464844.27000000136
2023-10-23 02:00:00,30195.2,2023-10-23 03:30:00,30488.0,-292.8,564551.4700000014,464551.47000000137
2023-10-23 03:45:00,30724.0,2023-10-23 07:30:00,30713.5,-10.5,564540.9700000014,464540.97000000137
2023-10-23 07:45:00,30508.0,2023-10-23 11:15:00,30628.6,-120.6,564420.3700000014,464420.3700000014
2023-10-23 11:30:00,30693.9,2023-10-23 22:30:00,35146.44,4452.54,568872.9100000013,468872.9100000014
2023-10-23 22:45:00,33358.8,2023-10-24 01:30:00,33795.7,-436.9,568436.0100000014,468436.01000000135
2023-10-24 01:45:00,34182.3,2023-10-24 05:30:00,34340.0,157.7,568593.7100000014,468593.71000000136
2023-10-24 05:45:00,33902.4,2023-10-24 10:15:00,34386.1,-483.7,568110.0100000014,468110.01000000135
2023-10-24 10:30:00,34438.7,2023-10-24 15:00:00,34311.8,-126.9,567983.1100000013,467983.1100000013
2023-10-24 15:15:00,33609.7,2023-10-24 21:30:00,33637.7,-28.0,567955.1100000013,467955.1100000013
2023-10-24 21:45:00,34123.3,2023-10-25 07:00:00,34137.1,13.8,567968.9100000013,467968.9100000013
2023-10-25 07:15:00,33876.5,2023-10-25 09:00:00,34047.8,-171.3,567797.6100000013,467797.6100000013
2023-10-25 09:15:00,34253.5,2023-10-25 19:15:00,34609.4,355.9,568153.5100000014,468153.51000000135
2023-10-25 19:30:00,34570.7,2023-10-26 00:45:00,34650.1,-79.4,568074.1100000013,468074.1100000013
2023-10-26 01:00:00,34652.7,2023-10-26 05:30:00,34600.0,-52.7,568021.4100000013,468021.4100000013
2023-10-26 05:45:00,34518.7,2023-10-26 07:00:00,34687.9,-169.2,567852.2100000014,467852.2100000013
2023-10-26 07:15:00,34778.9,2023-10-26 09:00:00,34483.8,-295.1,567557.1100000013,467557.1100000013
2023-10-26 09:15:00,34408.3,2023-10-26 19:45:00,34052.1,356.2,567913.3100000013,467913.31000000134
2023-10-26 20:00:00,34154.3,2023-10-27 00:30:00,34031.2,-123.1,567790.2100000014,467790.21000000136
2023-10-27 00:45:00,34020.0,2023-10-27 02:15:00,34075.7,-55.7,567734.5100000014,467734.51000000135
2023-10-27 02:30:00,34100.0,2023-10-27 07:30:00,34065.5,-34.5,567700.0100000014,467700.01000000135
2023-10-27 07:45:00,33954.0,2023-10-27 09:00:00,34138.1,-184.1,567515.9100000013,467515.9100000014
2023-10-27 09:15:00,34184.5,2023-10-27 14:30:00,33942.1,-305.03,567210.8800000013,467210.88000000134
2023-10-27 14:45:00,33913.5,2023-10-27 19:45:00,33705.5,208.0,567418.8800000013,467418.88000000134
2023-10-27 20:00:00,33714.5,2023-10-28 10:00:00,34111.84,397.34,567816.2200000014,467816.22000000137
2023-10-28 11:30:00,34212.9,2023-10-28 15:15:00,34153.3,59.6,567875.8200000013,467875.82000000135
2023-10-28 15:30:00,34190.9,2023-10-28 22:30:00,34125.6,-65.3,567810.5200000014,467810.52000000136
2023-10-28 22:45:00,34105.9,2023-10-29 05:45:00,34038.0,67.9,567878.4200000013,467878.4200000014
2023-10-29 06:00:00,34066.6,2023-10-29 21:30:00,34609.9,543.3,568421.7200000014,468421.72000000137
2023-10-29 21:45:00,34444.8,2023-10-29 22:30:00,34673.0,-228.2,568193.5200000014,468193.52000000136
2023-10-29 22:45:00,34708.2,2023-10-30 00:30:00,34495.2,-213.0,567980.5200000014,467980.52000000136
2023-10-30 00:45:00,34467.0,2023-10-30 08:45:00,34385.6,81.4,568061.9200000013,468061.9200000014
2023-10-30 09:00:00,34461.4,2023-10-30 16:00:00,34602.0,140.6,568202.5200000014,468202.52000000136
2023-10-30 16:15:00,34506.3,2023-10-30 19:15:00,34392.1,114.2,568316.7200000014,468316.72000000137
2023-10-30 19:30:00,34399.1,2023-10-31 02:15:00,34405.8,6.7,568323.4200000013,468323.4200000014
2023-10-31 02:30:00,34327.0,2023-10-31 08:00:00,34215.8,111.2,568434.6200000014,468434.6200000014
2023-10-31 08:15:00,34311.9,2023-10-31 13:15:00,34344.2,32.3,568466.9200000013,468466.9200000014
2023-10-31 13:30:00,34251.1,2023-10-31 18:15:00,34384.7,-133.6,568333.3200000015,468333.3200000014
2023-10-31 18:30:00,34425.0,2023-11-01 02:00:00,34503.2,78.2,568411.5200000014,468411.5200000014
2023-11-01 02:15:00,34486.3,2023-11-01 09:30:00,34471.9,14.4,568425.9200000014,468425.92000000144
2023-11-01 09:45:00,34499.9,2023-11-01 13:15:00,34753.5,253.6,568679.5200000014,468679.5200000014
2023-11-01 13:30:00,34576.3,2023-11-01 16:45:00,34458.4,117.9,568797.4200000014,468797.42000000144
2023-11-01 17:00:00,34504.2,2023-11-02 04:00:00,35602.5,1098.3,569895.7200000014,469895.7200000014
2023-11-02 04:15:00,35520.0,2023-11-02 09:15:00,35328.5,191.5,570087.2200000014,470087.2200000014
2023-11-02 09:30:00,35402.6,2023-11-02 13:15:00,35164.5,-238.1,569849.1200000015,469849.12000000145
2023-11-02 13:30:00,34911.5,2023-11-02 17:45:00,34776.4,135.1,569984.2200000014,469984.2200000014
2023-11-02 18:00:00,34827.0,2023-11-03 00:00:00,34866.5,39.5,570023.7200000014,470023.7200000014
2023-11-03 00:15:00,34765.7,2023-11-03 03:30:00,34671.4,94.3,570118.0200000014,470118.0200000014
2023-11-03 03:45:00,34680.0,2023-11-03 04:45:00,34406.5,-333.83,569784.1900000013,469784.1900000014
2023-11-03 07:30:00,34386.5,2023-11-03 13:30:00,34408.5,-22.0,569762.1900000013,469762.1900000014
2023-11-03 13:45:00,34576.2,2023-11-03 17:15:00,34523.6,-52.6,569709.5900000015,469709.5900000014
2023-11-03 17:30:00,34337.9,2023-11-03 20:45:00,34588.3,-250.4,569459.1900000013,469459.1900000014
2023-11-03 21:00:00,34645.5,2023-11-04 04:45:00,34658.1,12.6,569471.7900000014,469471.7900000014
2023-11-04 05:00:00,34587.1,2023-11-04 05:45:00,34755.9,-168.8,569302.9900000014,469302.9900000014
2023-11-04 06:00:00,34881.2,2023-11-04 06:00:00,34881.2,0.0,569302.9900000014,469302.9900000014
2023-11-04 06:15:00,34737.5,2023-11-04 18:30:00,34749.9,-12.4,569290.5900000014,469290.59000000136
2023-11-04 18:45:00,34775.9,2023-11-04 23:45:00,35069.7,293.8,569584.3900000013,469584.39000000135
2023-11-05 00:00:00,34957.2,2023-11-05 03:30:00,35150.2,-193.0,569391.3900000013,469391.39000000135
2023-11-05 03:45:00,35292.1,2023-11-05 06:15:00,35116.9,-175.2,569216.1900000013,469216.19000000134
2023-11-05 06:30:00,35070.4,2023-11-05 16:45:00,34969.6,100.8,569316.9900000014,469316.99000000133
2023-11-05 17:00:00,35212.6,2023-11-05 19:15:00,35109.2,-103.4,569213.5900000012,469213.5900000013
2023-11-05 19:30:00,35027.1,2023-11-05 22:00:00,34679.7,347.4,569560.9900000014,469560.99000000133
2023-11-05 22:15:00,34772.1,2023-11-05 23:30:00,35074.7,302.6,569863.5900000012,469863.5900000013
2023-11-05 23:45:00,35025.5,2023-11-06 08:45:00,34971.2,54.3,569917.8900000013,469917.8900000013
2023-11-06 09:00:00,35070.1,2023-11-06 13:15:00,35013.4,-56.7,569861.1900000013,469861.1900000013
2023-11-06 13:30:00,34939.5,2023-11-06 21:45:00,35039.8,-100.3,569760.8900000013,469760.8900000013
2023-11-06 22:00:00,35079.8,2023-11-07 00:15:00,34972.3,-107.5,569653.3900000013,469653.3900000013
2023-11-07 00:30:00,34889.7,2023-11-07 13:45:00,34780.0,109.7,569763.0900000012,469763.0900000013
2023-11-07 14:00:00,34794.8,2023-11-07 21:45:00,35495.2,700.4,570463.4900000014,470463.49000000133
2023-11-07 22:00:00,35329.1,2023-11-08 10:00:00,35338.0,-8.9,570454.5900000012,470454.5900000013
2023-11-08 10:15:00,35390.2,2023-11-08 14:45:00,35315.5,-74.7,570379.8900000013,470379.8900000013
2023-11-08 15:00:00,35222.4,2023-11-08 16:15:00,35253.1,-30.7,570349.1900000013,470349.1900000013
2023-11-08 16:30:00,35367.0,2023-11-08 21:00:00,35607.2,240.2,570589.3900000013,470589.3900000013
2023-11-08 21:15:00,35470.0,2023-11-08 23:15:00,35857.0,-387.0,570202.3900000013,470202.3900000013
2023-11-08 23:30:00,35910.0,2023-11-09 14:00:00,37968.63,2058.63,572261.0200000013,472261.0200000013
2023-11-09 14:15:00,37573.5,2023-11-09 17:30:00,36435.0,1138.5,573399.5200000013,473399.5200000013
2023-11-09 17:45:00,36649.8,2023-11-10 07:00:00,36648.3,-1.5,573398.0200000013,473398.0200000013
2023-11-10 07:15:00,36550.0,2023-11-10 10:30:00,36561.8,-11.8,573386.2200000014,473386.2200000013
2023-11-10 10:45:00,36775.2,2023-11-11 01:00:00,37246.1,470.9,573857.1200000013,473857.12000000133
2023-11-11 01:15:00,37173.7,2023-11-11 13:15:00,37111.1,62.6,573919.7200000014,473919.7200000013
2023-11-11 13:30:00,37169.5,2023-11-11 15:30:00,37156.7,-12.8,573906.9200000013,473906.9200000013
2023-11-11 15:45:00,37071.5,2023-11-11 22:00:00,36819.9,251.6,574158.5200000013,474158.5200000013
2023-11-11 22:15:00,36903.5,2023-11-12 04:15:00,36983.5,80.0,574238.5200000013,474238.5200000013
2023-11-12 04:30:00,36976.7,2023-11-12 06:00:00,37131.2,-154.5,574084.0200000013,474084.0200000013
2023-11-12 06:15:00,37146.1,2023-11-12 12:00:00,37116.0,-30.1,574053.9200000013,474053.9200000013
2023-11-12 12:15:00,37022.0,2023-11-12 13:45:00,37101.0,-79.0,573974.9200000013,473974.9200000013
2023-11-12 14:00:00,37144.0,2023-11-12 17:45:00,37108.4,-35.6,573939.3200000013,473939.32000000135
2023-11-12 18:00:00,37090.7,2023-11-12 22:15:00,37187.4,-143.28,573796.0400000013,473796.0400000013
2023-11-13 01:00:00,37230.0,2023-11-13 02:45:00,37166.1,-63.9,573732.1400000013,473732.1400000013
2023-11-13 03:00:00,37060.8,2023-11-13 07:00:00,37038.6,22.2,573754.3400000012,473754.3400000013
2023-11-13 07:15:00,37056.0,2023-11-13 11:15:00,36885.6,-170.4,573583.9400000013,473583.9400000013
2023-11-13 11:30:00,36807.0,2023-11-13 12:30:00,36866.1,-59.1,573524.8400000012,473524.8400000013
2023-11-13 12:45:00,36952.6,2023-11-13 14:45:00,36812.2,-336.69,573188.1500000013,473188.1500000013
2023-11-13 18:00:00,36666.0,2023-11-14 04:15:00,36418.6,247.4,573435.5500000013,473435.5500000013
2023-11-14 04:30:00,36521.5,2023-11-14 09:30:00,36619.6,98.1,573533.6500000013,473533.6500000013
2023-11-14 09:45:00,36507.4,2023-11-14 13:45:00,36528.4,-21.0,573512.6500000013,473512.6500000013
2023-11-14 14:00:00,36602.1,2023-11-14 15:00:00,36522.0,-80.1,573432.5500000013,473432.5500000013
2023-11-14 15:15:00,36271.7,2023-11-14 15:45:00,36168.7,103.0,573535.5500000013,473535.5500000013
2023-11-14 16:00:00,36303.4,2023-11-14 17:45:00,36119.9,-183.5,573352.0500000013,473352.0500000013
2023-11-14 18:00:00,35889.0,2023-11-14 18:45:00,35239.5,649.5,574001.5500000013,474001.5500000013
2023-11-14 19:00:00,35380.1,2023-11-15 13:15:00,36072.3,692.2,574693.7500000014,474693.75000000134
2023-11-15 13:30:00,36051.6,2023-11-15 15:30:00,36266.1,-214.5,574479.2500000014,474479.25000000134
2023-11-15 15:45:00,36412.1,2023-11-16 03:00:00,37543.9,1131.8,575611.0500000013,475611.0500000013
2023-11-16 03:15:00,37429.9,2023-11-16 11:00:00,37466.6,-36.7,575574.3500000013,475574.3500000013
2023-11-16 11:15:00,37549.4,2023-11-16 11:45:00,37272.1,-378.83,575195.5200000013,475195.5200000013
2023-11-16 12:15:00,37095.0,2023-11-16 22:00:00,36100.7,994.3,576189.8200000012,476189.8200000013
2023-11-16 22:15:00,36182.8,2023-11-17 06:45:00,36363.3,180.5,576370.3200000012,476370.3200000013
2023-11-17 07:00:00,36294.1,2023-11-17 12:30:00,36403.0,-108.9,576261.4200000013,476261.42000000126
2023-11-17 12:45:00,36540.8,2023-11-17 14:15:00,36332.9,-207.9,576053.5200000012,476053.52000000124
2023-11-17 14:30:00,36193.9,2023-11-17 17:00:00,36379.5,-649.57,575403.9500000012,475403.95000000123
2023-11-17 18:00:00,36526.6,2023-11-18 00:45:00,36403.3,-123.3,575280.6500000013,475280.65000000125
2023-11-18 01:00:00,36395.0,2023-11-18 07:30:00,36351.9,43.1,575323.7500000012,475323.7500000012
2023-11-18 07:45:00,36429.0,2023-11-18 17:30:00,36654.6,225.6,575549.3500000013,475549.3500000012
2023-11-18 17:45:00,36633.5,2023-11-19 04:45:00,36544.0,89.5,575638.8500000013,475638.8500000012
2023-11-19 05:00:00,36545.1,2023-11-19 10:00:00,36587.3,42.2,575681.0500000012,475681.0500000012
2023-11-19 10:15:00,36553.5,2023-11-19 15:30:00,36541.6,11.9,575692.9500000012,475692.95000000123
2023-11-19 15:45:00,36575.1,2023-11-20 03:15:00,37257.2,682.1,576375.0500000012,476375.0500000012
2023-11-20 03:30:00,37090.1,2023-11-20 10:45:00,37300.8,-279.0,576096.0500000012,476096.0500000012
2023-11-20 11:00:00,37371.7,2023-11-20 11:45:00,37161.0,-210.7,575885.3500000013,475885.3500000012
2023-11-20 12:00:00,37136.4,2023-11-20 14:00:00,36890.0,246.4,576131.7500000012,476131.7500000012
2023-11-20 14:15:00,37135.8,2023-11-20 17:00:00,37253.1,117.3,576249.0500000012,476249.0500000012
2023-11-20 17:15:00,37043.9,2023-11-20 17:30:00,37405.1,-361.2,575887.8500000013,475887.8500000012
2023-11-20 17:45:00,37598.1,2023-11-21 04:15:00,37484.7,-113.4,575774.4500000011,475774.4500000012
2023-11-21 04:30:00,37452.8,2023-11-21 15:30:00,36568.1,884.7,576659.1500000012,476659.1500000012
2023-11-21 15:45:00,36975.9,2023-11-21 17:15:00,37287.9,312.0,576971.1500000012,476971.1500000012
2023-11-21 17:30:00,36846.9,2023-11-22 02:15:00,36112.8,734.1,577705.2500000012,477705.25000000116
2023-11-22 02:30:00,36178.1,2023-11-22 11:30:00,36515.9,337.8,578043.0500000012,478043.05000000115
2023-11-22 11:45:00,36465.9,2023-11-22 17:45:00,36582.9,-117.0,577926.0500000012,477926.05000000115
2023-11-22 18:00:00,36705.2,2023-11-22 22:45:00,37457.0,751.8,578677.8500000011,478677.85000000114
2023-11-22 23:00:00,37298.5,2023-11-23 08:15:00,37440.1,-141.6,578536.2500000012,478536.25000000116
2023-11-23 08:30:00,37491.0,2023-11-23 10:45:00,37470.0,-21.0,578515.2500000012,478515.25000000116
2023-11-23 11:00:00,37388.0,2023-11-23 11:45:00,37378.2,9.8,578525.0500000012,478525.05000000115
2023-11-23 12:00:00,37450.5,2023-11-23 14:00:00,37263.6,-186.9,578338.1500000011,478338.15000000113
2023-11-23 14:15:00,37179.3,2023-11-23 17:00:00,37212.6,-33.3,578304.8500000011,478304.85000000114
2023-11-23 17:15:00,37230.0,2023-11-24 10:30:00,37680.0,450.0,578754.8500000011,478754.85000000114
2023-11-24 10:45:00,37611.2,2023-11-24 11:30:00,37965.5,-455.81,578299.0400000012,478299.04000000114
2023-11-24 15:15:00,38287.9,2023-11-24 16:30:00,38088.1,-199.8,578099.2400000012,478099.24000000115
2023-11-24 16:45:00,37733.3,2023-11-25 02:15:00,37709.9,23.4,578122.6400000012,478122.6400000012
2023-11-25 02:30:00,37791.3,2023-11-25 10:00:00,37705.1,-86.2,578036.4400000011,478036.44000000117
2023-11-25 10:15:00,37679.2,2023-11-25 12:30:00,37684.7,-5.5,578030.9400000011,478030.94000000117
2023-11-25 12:45:00,37717.8,2023-11-25 21:45:00,37780.9,63.1,578094.0400000012,478094.04000000114
2023-11-25 22:00:00,37723.8,2023-11-26 04:30:00,37734.3,-10.5,578083.5400000012,478083.54000000114
2023-11-26 04:45:00,37752.1,2023-11-26 10:00:00,37724.1,-28.0,578055.5400000012,478055.54000000114
2023-11-26 10:15:00,37715.2,2023-11-26 12:15:00,37565.0,150.2,578205.7400000012,478205.74000000115
2023-11-26 12:30:00,37511.6,2023-11-26 16:30:00,37260.0,-355.7,577850.0400000012,477850.04000000114
2023-11-26 16:45:00,37212.1,2023-11-26 20:15:00,37404.4,-192.3,577657.7400000012,477657.74000000115
2023-11-26 20:30:00,37454.4,2023-11-26 22:45:00,37647.5,193.1,577850.8400000011,477850.84000000113
2023-11-26 23:00:00,37380.0,2023-11-27 07:45:00,37272.1,107.9,577958.7400000012,477958.74000000115
2023-11-27 08:00:00,37325.3,2023-11-27 10:15:00,37218.9,-106.4,577852.3400000011,477852.34000000113
2023-11-27 10:30:00,37105.7,2023-11-27 17:00:00,37109.7,-4.0,577848.3400000011,477848.34000000113
2023-11-27 17:15:00,37115.4,2023-11-28 03:15:00,37147.1,31.7,577880.0400000012,477880.04000000114
2023-11-28 03:30:00,37112.9,2023-11-28 06:30:00,37050.0,62.9,577942.9400000011,477942.94000000117
2023-11-28 06:45:00,37088.7,2023-11-28 21:30:00,37972.5,883.8,578826.7400000012,478826.74000000115
2023-11-28 21:45:00,37932.0,2023-11-29 00:45:00,37904.3,27.7,578854.4400000011,478854.44000000117
2023-11-29 01:00:00,38052.9,2023-11-29 10:00:00,38211.0,158.1,579012.5400000012,479012.54000000114
2023-11-29 10:15:00,38112.9,2023-11-29 23:15:00,37828.7,284.2,579296.7400000012,479296.74000000115
2023-11-29 23:30:00,37856.1,2023-11-30 05:30:00,37899.8,43.7,579340.4400000011,479340.44000000117
2023-11-30 05:45:00,37871.1,2023-11-30 11:15:00,37740.1,131.0,579471.4400000011,479471.44000000117
2023-11-30 11:30:00,37801.6,2023-11-30 14:00:00,37706.5,-346.52,579124.9200000011,479124.92000000115
2023-11-30 15:30:00,37566.1,2023-11-30 18:00:00,37722.3,-156.2,578968.7200000011,478968.72000000114
2023-11-30 18:15:00,37790.0,2023-12-01 12:15:00,38539.7,749.7,579718.4200000011,479718.42000000115
2023-12-01 12:30:00,38370.9,2023-12-01 16:00:00,38477.1,-106.2,579612.2200000011,479612.22000000114
2023-12-01 16:15:00,38779.9,2023-12-01 22:30:00,38724.0,-55.9,579556.3200000011,479556.3200000011
2023-12-01 22:45:00,38683.7,2023-12-02 04:30:00,38723.0,-39.3,579517.0200000012,479517.0200000011
2023-12-02 04:45:00,38804.0,2023-12-02 08:15:00,38680.1,-163.97,579353.0500000012,479353.05000000115
2023-12-02 19:15:00,39342.0,2023-12-02 20:30:00,39415.1,-73.1,579279.9500000011,479279.9500000012
2023-12-02 20:45:00,39570.1,2023-12-03 02:00:00,39517.9,-52.2,579227.7500000012,479227.75000000116
2023-12-03 02:15:00,39404.4,2023-12-03 07:00:00,39395.4,9.0,579236.7500000012,479236.75000000116
2023-12-03 07:15:00,39440.0,2023-12-03 17:15:00,39513.2,73.2,579309.9500000011,479309.9500000012
2023-12-03 17:30:00,39499.9,2023-12-03 21:15:00,39610.2,-110.3,579199.6500000012,479199.6500000012
2023-12-03 21:30:00,39663.8,2023-12-03 23:00:00,40113.8,450.0,579649.6500000012,479649.6500000012
2023-12-03 23:15:00,39852.3,2023-12-04 00:45:00,40217.6,-365.3,579284.3500000013,479284.3500000012
2023-12-04 01:00:00,40234.7,2023-12-04 10:30:00,41854.77,1620.07,580904.4200000012,480904.4200000012
2023-12-04 14:15:00,41526.4,2023-12-04 18:00:00,41555.0,-28.6,580875.8200000012,480875.82000000123
2023-12-04 18:15:00,41677.7,2023-12-04 23:00:00,41894.1,216.4,581092.2200000013,481092.22000000125
2023-12-04 23:15:00,41814.2,2023-12-05 09:45:00,41701.0,113.2,581205.4200000013,481205.42000000126
2023-12-05 10:00:00,41718.5,2023-12-05 21:45:00,44266.99,2548.49,583753.9100000013,483753.91000000125
2023-12-06 02:00:00,43805.5,2023-12-06 09:45:00,43890.8,-85.3,583668.6100000013,483668.61000000127
2023-12-06 10:00:00,44066.1,2023-12-06 11:00:00,43782.0,-284.1,583384.5100000013,483384.5100000013
2023-12-06 11:15:00,43710.4,2023-12-06 12:15:00,43932.7,-222.3,583162.2100000014,483162.2100000013
2023-12-06 12:30:00,44179.6,2023-12-06 20:30:00,43987.2,-192.4,582969.8100000012,482969.8100000013
2023-12-06 20:45:00,43756.1,2023-12-07 02:00:00,43944.5,-188.4,582781.4100000013,482781.41000000125
2023-12-07 02:15:00,43958.2,2023-12-07 07:45:00,43899.4,-58.8,582722.6100000013,482722.61000000127
2023-12-07 08:00:00,43766.0,2023-12-07 09:15:00,43083.1,682.9,583405.5100000013,483405.5100000013
2023-12-07 09:30:00,43366.1,2023-12-07 17:15:00,43610.2,244.1,583649.6100000013,483649.61000000127
2023-12-07 17:30:00,43372.8,2023-12-08 01:30:00,43437.1,-64.3,583585.3100000012,483585.3100000013
2023-12-08 01:45:00,43429.9,2023-12-08 07:00:00,43376.1,-53.8,583531.5100000013,483531.5100000013
2023-12-08 07:15:00,43163.7,2023-12-08 10:45:00,43394.9,-231.2,583300.3100000012,483300.3100000013
2023-12-08 11:00:00,43477.1,2023-12-08 22:45:00,44296.6,819.5,584119.8100000012,484119.8100000013
2023-12-08 23:00:00,44303.5,2023-12-09 05:00:00,44271.0,32.5,584152.3100000012,484152.3100000013
2023-12-09 05:15:00,44373.8,2023-12-09 08:15:00,44162.8,-211.0,583941.3100000012,483941.3100000013
2023-12-09 08:30:00,43795.7,2023-12-09 08:30:00,43795.7,-318.56,583622.7500000013,483622.7500000013
2023-12-09 14:00:00,44130.9,2023-12-09 14:45:00,43963.6,-351.97,583270.7800000013,483270.7800000013
2023-12-09 20:00:00,43928.1,2023-12-10 01:00:00,43758.9,169.2,583439.9800000014,483439.9800000013
2023-12-10 01:15:00,43869.9,2023-12-10 08:15:00,43910.2,40.3,583480.2800000013,483480.2800000013
2023-12-10 08:30:00,43820.4,2023-12-10 12:30:00,43810.4,10.0,583490.2800000013,483490.2800000013
2023-12-10 12:45:00,43912.1,2023-12-10 17:00:00,43862.6,-49.5,583440.7800000013,483440.7800000013
2023-12-10 17:15:00,43798.4,2023-12-10 20:15:00,43866.7,-68.3,583372.4800000014,483372.4800000013
2023-12-10 20:30:00,43968.6,2023-12-10 21:15:00,43890.9,-77.7,583294.7800000013,483294.7800000013
2023-12-10 21:30:00,43826.6,2023-12-11 02:00:00,40882.96,2943.64,586238.4200000013,486238.4200000013
2023-12-11 02:15:00,42233.2,2023-12-11 13:15:00,42141.9,-91.3,586147.1200000013,486147.12000000133
2023-12-11 13:30:00,42100.4,2023-12-11 20:45:00,40882.1,1218.3,587365.4200000013,487365.4200000013
2023-12-11 21:00:00,41120.0,2023-12-12 04:30:00,41538.0,418.0,587783.4200000013,487783.4200000013
2023-12-12 04:45:00,41411.8,2023-12-12 07:00:00,41810.1,-436.5,587346.9200000013,487346.9200000013
2023-12-12 07:15:00,41835.3,2023-12-12 11:15:00,41802.9,-32.4,587314.5200000013,487314.5200000013
2023-12-12 11:30:00,41658.4,2023-12-12 18:00:00,41183.6,474.8,587789.3200000012,487789.3200000013
2023-12-12 18:15:00,41425.6,2023-12-13 01:00:00,41370.2,-55.4,587733.9200000013,487733.92000000126
2023-12-13 01:15:00,41033.5,2023-12-13 05:30:00,40964.0,69.5,587803.4200000013,487803.42000000126
2023-12-13 05:45:00,41046.5,2023-12-13 19:30:00,42859.6,1813.1,589616.5200000012,489616.52000000124
2023-12-13 23:45:00,42875.0,2023-12-14 10:45:00,42967.7,-92.7,589523.8200000012,489523.82000000123
2023-12-14 11:00:00,43021.7,2023-12-14 12:45:00,43100.1,78.4,589602.2200000013,489602.22000000125
2023-12-14 13:00:00,42809.9,2023-12-14 13:30:00,42491.1,318.8,589921.0200000012,489921.02000000124
2023-12-14 13:45:00,42564.7,2023-12-14 23:15:00,43080.1,515.4,590436.4200000013,490436.42000000126
2023-12-14 23:30:00,42991.2,2023-12-15 03:45:00,42813.5,177.7,590614.1200000013,490614.1200000013
2023-12-15 04:00:00,42813.1,2023-12-15 11:45:00,42800.0,-13.1,590601.0200000013,490601.0200000013
2023-12-15 12:00:00,42670.3,2023-12-15 19:00:00,42092.6,577.7,591178.7200000014,491178.7200000013
2023-12-15 19:15:00,42127.6,2023-12-16 00:15:00,41899.2,-228.4,590950.3200000012,490950.3200000013
2023-12-16 00:30:00,41794.4,2023-12-16 01:00:00,42079.1,-284.7,590665.6200000013,490665.6200000013
2023-12-16 01:15:00,42155.0,2023-12-16 08:15:00,42230.6,75.6,590741.2200000013,490741.22000000125
2023-12-16 08:30:00,42157.8,2023-12-16 11:30:00,42314.1,-156.3,590584.9200000013,490584.92000000126
2023-12-16 11:45:00,42349.9,2023-12-16 18:00:00,42463.8,113.9,590698.8200000012,490698.8200000013
2023-12-16 18:15:00,42423.0,2023-12-17 10:00:00,41993.5,429.5,591128.3200000012,491128.3200000013
2023-12-17 10:15:00,41992.9,2023-12-17 14:30:00,41761.1,-344.93,590783.3900000013,490783.3900000013
2023-12-17 14:45:00,41646.5,2023-12-17 16:15:00,41909.2,-262.7,590520.6900000013,490520.6900000013
2023-12-17 16:30:00,42012.6,2023-12-17 17:45:00,42121.2,108.6,590629.2900000012,490629.29000000126
2023-12-17 18:00:00,41919.0,2023-12-18 06:00:00,41074.2,844.8,591474.0900000012,491474.09000000125
2023-12-18 06:15:00,41242.5,2023-12-18 09:00:00,41070.4,-172.1,591301.9900000013,491301.9900000013
2023-12-18 09:15:00,40914.3,2023-12-18 10:45:00,40845.9,68.4,591370.3900000013,491370.3900000013
2023-12-18 11:00:00,41210.8,2023-12-19 00:00:00,42897.4,1686.6,593056.9900000013,493056.9900000013
2023-12-19 04:30:00,42891.8,2023-12-19 21:00:00,42320.1,571.7,593628.6900000013,493628.6900000013
2023-12-19 21:15:00,42391.1,2023-12-20 16:45:00,43725.9,1334.8,594963.4900000013,494963.4900000013
2023-12-20 17:00:00,43651.2,2023-12-20 19:00:00,44084.5,-631.82,594331.6700000013,494331.67000000126
2023-12-21 05:00:00,43661.9,2023-12-21 14:15:00,43842.4,180.5,594512.1700000013,494512.17000000126
2023-12-21 14:30:00,43697.2,2023-12-21 21:15:00,43809.5,-112.3,594399.8700000013,494399.8700000013
2023-12-21 21:30:00,44048.4,2023-12-22 06:30:00,44017.1,-31.3,594368.5700000012,494368.5700000013
2023-12-22 06:45:00,43906.4,2023-12-22 18:00:00,43770.4,136.0,594504.5700000012,494504.5700000013
2023-12-22 18:15:00,43900.8,2023-12-22 20:30:00,43728.1,-172.7,594331.8700000013,494331.8700000013
2023-12-22 20:45:00,43672.5,2023-12-22 23:00:00,43946.1,-304.11,594027.7600000013,494027.7600000013
2023-12-22 23:15:00,43999.9,2023-12-23 01:30:00,43788.3,-211.6,593816.1600000013,493816.1600000013
2023-12-23 01:45:00,43656.9,2023-12-23 05:30:00,43600.0,56.9,593873.0600000013,493873.06000000134
2023-12-23 05:45:00,43632.2,2023-12-23 23:45:00,43725.2,93.0,593966.0600000013,493966.06000000134
2023-12-24 00:00:00,43680.5,2023-12-24 00:45:00,43749.3,-68.8,593897.2600000014,493897.26000000135
2023-12-24 01:00:00,43859.2,2023-12-24 05:00:00,43760.0,-99.2,593798.0600000013,493798.06000000134
2023-12-24 05:15:00,43700.1,2023-12-24 09:15:00,43664.2,35.9,593833.9600000014,493833.96000000136
2023-12-24 09:30:00,43716.9,2023-12-24 10:30:00,43535.2,-254.47,593579.4900000014,493579.4900000014
2023-12-24 16:00:00,43643.6,2023-12-24 23:00:00,43106.0,537.6,594117.0900000014,494117.09000000136
2023-12-24 23:15:00,43111.0,2023-12-25 10:45:00,43204.6,93.6,594210.6900000013,494210.69000000134
2023-12-25 11:00:00,43112.3,2023-12-25 12:30:00,43174.9,-62.6,594148.0900000014,494148.09000000136
2023-12-25 12:45:00,43700.1,2023-12-25 12:45:00,43700.1,-355.51,593792.5800000014,493792.58000000136
2023-12-25 20:00:00,43438.0,2023-12-25 22:15:00,43663.6,-225.6,593566.9800000014,493566.9800000014
2023-12-25 22:30:00,43758.2,2023-12-26 00:45:00,43491.2,-293.58,593273.4000000013,493273.40000000136
2023-12-26 02:15:00,43486.8,2023-12-26 09:45:00,42120.45,1366.35,594639.7500000014,494639.75000000134
2023-12-26 10:15:00,42604.1,2023-12-26 15:30:00,42606.8,2.7,594642.4500000014,494642.45000000135
2023-12-26 15:45:00,42423.1,2023-12-26 18:30:00,42032.6,390.5,595032.9500000014,495032.95000000135
2023-12-26 18:45:00,42196.8,2023-12-27 02:30:00,42305.3,108.5,595141.4500000014,495141.45000000135
2023-12-27 02:45:00,42264.4,2023-12-27 05:30:00,42380.6,-116.2,595025.2500000014,495025.25000000134
2023-12-27 05:45:00,42485.7,2023-12-27 12:15:00,43043.7,558.0,595583.2500000014,495583.25000000134
2023-12-27 12:30:00,42851.6,2023-12-27 18:30:00,43060.0,-208.4,595374.8500000013,495374.8500000013
2023-12-27 18:45:00,43217.6,2023-12-28 02:30:00,43424.6,207.0,595581.8500000013,495581.8500000013
2023-12-28 02:45:00,43390.8,2023-12-28 10:15:00,43163.5,227.3,595809.1500000013,495809.1500000013
2023-12-28 10:30:00,43199.8,2023-12-28 12:30:00,42946.8,-253.0,595556.1500000013,495556.1500000013
2023-12-28 12:45:00,42827.4,2023-12-28 23:00:00,42600.6,226.8,595782.9500000014,495782.9500000013
2023-12-28 23:15:00,42737.3,2023-12-29 01:00:00,42504.8,-487.26,595295.6900000013,495295.6900000013
2023-12-29 07:30:00,42376.1,2023-12-29 09:15:00,42654.9,-278.8,595016.8900000013,495016.8900000013
2023-12-29 09:30:00,42685.2,2023-12-29 15:15:00,42754.4,69.2,595086.0900000012,495086.0900000013
2023-12-29 15:30:00,42562.0,2023-12-29 20:45:00,42073.2,488.8,595574.8900000013,495574.8900000013
2023-12-29 21:00:00,42243.1,2023-12-29 22:15:00,41804.7,-600.85,594974.0400000013,494974.0400000013
2023-12-30 03:15:00,41863.6,2023-12-30 06:00:00,42150.0,-316.03,594658.0100000013,494658.0100000013
2023-12-30 11:00:00,41967.3,2023-12-30 20:15:00,42408.9,441.6,595099.6100000013,495099.61000000127
2023-12-30 20:30:00,42263.8,2023-12-31 04:00:00,42268.4,-4.6,595095.0100000013,495095.0100000013
2023-12-31 04:15:00,42329.9,2023-12-31 11:15:00,42633.8,303.9,595398.9100000013,495398.9100000013
2023-12-31 11:30:00,42610.0,2023-12-31 18:15:00,42670.7,-60.7,595338.2100000014,495338.2100000013
2023-12-31 18:30:00,42741.6,2023-12-31 22:30:00,42523.6,-218.0,595120.2100000014,495120.2100000013
2023-12-31 22:45:00,42294.8,2023-12-31 23:45:00,42314.0,-19.2,595101.0100000013,495101.0100000013
2024-01-01 00:00:00,42532.5,2024-01-01 03:00:00,42544.2,11.7,595112.7100000014,495112.7100000013
2024-01-01 03:15:00,42466.9,2024-01-01 07:00:00,42482.2,-15.3,595097.4100000013,495097.4100000013
2024-01-01 07:15:00,42524.9,2024-01-01 20:00:00,43767.8,1242.9,596340.3100000013,496340.31000000134
2024-01-02 11:30:00,45307.9,2024-01-03 00:45:00,45168.1,139.8,596480.1100000013,496480.1100000013
2024-01-03 01:00:00,45215.5,2024-01-03 07:30:00,45174.9,-40.6,596439.5100000014,496439.51000000135
2024-01-03 07:45:00,45030.4,2024-01-03 09:00:00,45331.4,-301.0,596138.5100000014,496138.51000000135
2024-01-03 09:15:00,45394.2,2024-01-03 10:15:00,45315.7,-78.5,596060.0100000014,496060.01000000135
2024-01-03 10:30:00,45097.8,2024-01-03 12:00:00,40688.94,4408.86,600468.8700000013,500468.87000000133
2024-01-03 12:15:00,42323.6,2024-01-03 18:30:00,42704.4,380.8,600849.6700000013,500849.6700000013
2024-01-03 18:45:00,42267.6,2024-01-03 21:15:00,42821.8,-554.2,600295.4700000014,500295.4700000013
2024-01-03 21:30:00,42870.5,2024-01-04 07:30:00,42995.3,124.8,600420.2700000013,500420.2700000013
2024-01-04 07:45:00,42775.0,2024-01-04 11:30:00,43168.4,-393.4,600026.8700000013,500026.8700000013
2024-01-04 11:45:00,43188.2,2024-01-05 00:15:00,44212.1,1023.9,601050.7700000013,501050.7700000013
2024-01-05 00:30:00,44096.8,2024-01-05 01:45:00,43374.5,722.3,601773.0700000012,501773.0700000013
2024-01-05 02:00:00,43631.9,2024-01-05 10:30:00,43928.7,296.8,602069.8700000013,502069.8700000013
2024-01-05 10:45:00,43628.2,2024-01-05 19:15:00,43567.4,60.8,602130.6700000013,502130.67000000126
2024-01-05 19:30:00,43656.9,2024-01-05 20:45:00,43951.6,294.7,602425.3700000013,502425.3700000013
2024-01-05 21:00:00,43749.0,2024-01-06 13:15:00,43670.1,78.9,602504.2700000013,502504.2700000013
2024-01-06 13:30:00,43702.5,2024-01-06 19:45:00,43903.6,201.1,602705.3700000013,502705.3700000013
2024-01-06 20:00:00,43767.3,2024-01-07 00:15:00,43959.5,-192.2,602513.1700000013,502513.17000000126
2024-01-07 00:30:00,44154.4,2024-01-07 03:45:00,43937.2,-217.2,602295.9700000013,502295.97000000125
2024-01-07 04:00:00,43893.6,2024-01-07 08:00:00,44076.6,-183.0,602112.9700000013,502112.97000000125
2024-01-07 08:15:00,44133.8,2024-01-07 15:15:00,44166.2,32.4,602145.3700000013,502145.3700000013
2024-01-07 15:30:00,44084.7,2024-01-07 17:45:00,44056.3,28.4,602173.7700000013,502173.7700000013
2024-01-07 18:00:00,44098.9,2024-01-07 22:30:00,43964.5,-134.4,602039.3700000013,502039.3700000013
2024-01-07 22:45:00,43851.3,2024-01-08 05:30:00,43548.3,303.0,602342.3700000013,502342.3700000013
2024-01-08 05:45:00,43630.5,2024-01-08 08:15:00,43995.0,364.5,602706.8700000013,502706.8700000013
2024-01-08 08:30:00,43898.8,2024-01-08 10:45:00,44081.6,-182.8,602524.0700000012,502524.0700000013
2024-01-08 11:00:00,44173.6,2024-01-08 21:30:00,47077.37,2903.77,605427.8400000012,505427.8400000013
2024-01-09 01:30:00,46362.8,2024-01-09 06:45:00,46794.5,-431.7,604996.1400000013,504996.1400000013
2024-01-09 07:00:00,46817.4,2024-01-09 10:30:00,46572.5,-244.9,604751.2400000013,504751.2400000013
2024-01-09 10:45:00,46449.9,2024-01-09 12:45:00,46175.5,274.4,605025.6400000013,505025.6400000013
2024-01-09 13:00:00,46569.6,2024-01-09 21:15:00,45899.5,-1570.08,603455.5600000012,503455.5600000013
2024-01-09 21:30:00,45973.8,2024-01-10 02:45:00,45990.0,-16.2,603439.3600000013,503439.36000000127
2024-01-10 03:00:00,46175.4,2024-01-10 08:00:00,45793.1,-382.3,603057.0600000012,503057.0600000013
2024-01-10 08:15:00,45745.3,2024-01-10 11:45:00,45530.2,215.1,603272.1600000013,503272.16000000125
2024-01-10 12:00:00,45480.8,2024-01-10 12:30:00,45023.2,-457.6,602814.5600000012,502814.5600000013
2024-01-10 12:45:00,44679.2,2024-01-10 14:00:00,44961.1,-281.9,602532.6600000013,502532.66000000125
2024-01-10 14:15:00,45331.0,2024-01-11 02:15:00,46551.5,1220.5,603753.1600000013,503753.16000000125
2024-01-11 02:30:00,46547.1,2024-01-11 08:00:00,46193.2,353.9,604107.0600000012,504107.0600000013
2024-01-11 08:15:00,46294.2,2024-01-11 15:15:00,47816.0,1521.8,605628.8600000013,505628.86000000127
2024-01-11 15:30:00,47237.4,2024-01-11 19:45:00,46698.4,539.0,606167.8600000013,506167.86000000127
2024-01-11 20:00:00,46952.4,2024-01-12 00:15:00,46276.9,-734.65,605433.2100000012,505433.21000000124
2024-01-12 01:00:00,46137.7,2024-01-12 11:00:00,46025.5,112.2,605545.4100000013,505545.41000000125
2024-01-12 11:15:00,46230.7,2024-01-12 13:30:00,45695.9,-613.39,604932.0200000012,504932.02000000124
2024-01-12 14:30:00,45315.9,2024-01-12 22:45:00,42517.9,2798.0,607730.0200000012,507730.02000000124
2024-01-12 23:00:00,42827.9,2024-01-13 09:45:00,42927.4,99.5,607829.5200000012,507829.52000000124
2024-01-13 10:00:00,42713.3,2024-01-13 15:00:00,42977.3,-264.0,607565.5200000012,507565.52000000124
2024-01-13 15:15:00,43096.6,2024-01-13 18:30:00,42827.6,-269.0,607296.5200000012,507296.52000000124
2024-01-13 18:45:00,42807.9,2024-01-14 05:45:00,42757.5,50.4,607346.9200000013,507346.92000000126
2024-01-14 06:00:00,42873.6,2024-01-14 12:30:00,42850.1,-23.5,607323.4200000013,507323.42000000126
2024-01-14 12:45:00,42760.3,2024-01-14 20:00:00,42668.7,91.6,607415.0200000012,507415.02000000124
2024-01-14 20:15:00,42656.0,2024-01-14 21:30:00,42312.8,-580.41,606834.6100000013,506834.61000000127
2024-01-14 23:00:00,42043.3,2024-01-15 02:15:00,42305.4,-262.1,606572.5100000013,506572.5100000013
2024-01-15 02:30:00,42328.3,2024-01-15 14:00:00,42626.0,297.7,606870.2100000014,506870.2100000013
2024-01-15 14:15:00,42441.4,2024-01-15 16:45:00,42525.0,-83.6,606786.6100000013,506786.6100000013
2024-01-15 17:00:00,42693.0,2024-01-15 20:45:00,42961.3,268.3,607054.9100000013,507054.9100000013
2024-01-15 21:00:00,42834.6,2024-01-16 03:00:00,42715.6,119.0,607173.9100000013,507173.9100000013
2024-01-16 03:15:00,42793.9,2024-01-16 11:00:00,42917.2,123.3,607297.2100000014,507297.2100000013
2024-01-16 11:15:00,42819.0,2024-01-16 12:30:00,43066.2,-247.2,607050.0100000013,507050.0100000013
2024-01-16 12:45:00,43160.1,2024-01-16 13:45:00,42805.7,-397.6,606652.4100000013,506652.4100000013
2024-01-16 14:30:00,42107.4,2024-01-16 14:30:00,42107.4,-565.29,606087.1200000013,506087.12000000133
2024-01-16 15:15:00,42970.6,2024-01-16 23:30:00,43148.0,177.4,606264.5200000014,506264.52000000136
2024-01-16 23:45:00,43133.0,2024-01-17 12:30:00,42671.3,461.7,606726.2200000014,506726.22000000137
2024-01-17 12:45:00,42785.2,2024-01-17 16:00:00,42494.2,-291.0,606435.2200000014,506435.22000000137
2024-01-17 16:15:00,42398.0,2024-01-17 19:00:00,42580.5,-182.5,606252.7200000014,506252.72000000137
2024-01-17 19:15:00,42727.3,2024-01-18 10:15:00,42687.8,-39.5,606213.2200000014,506213.22000000137
2024-01-18 10:30:00,42583.6,2024-01-18 14:30:00,42543.2,40.4,606253.6200000014,506253.6200000014
2024-01-18 14:45:00,42742.6,2024-01-18 16:00:00,42481.9,-260.7,605992.9200000013,505992.9200000014
2024-01-18 16:15:00,42456.3,2024-01-18 23:30:00,41308.1,1148.2,607141.1200000014,507141.1200000014
2024-01-18 23:45:00,41323.1,2024-01-19 03:30:00,41017.7,-515.46,606625.6600000013,506625.6600000014
2024-01-19 08:00:00,41177.5,2024-01-19 17:15:00,40731.7,445.8,607071.4600000014,507071.46000000136
2024-01-19 17:30:00,41073.3,2024-01-19 23:15:00,41654.1,580.8,607652.2600000014,507652.26000000135
2024-01-19 23:30:00,41648.6,2024-01-20 06:45:00,41669.0,-20.4,607631.8600000013,507631.8600000013
2024-01-20 07:00:00,41691.7,2024-01-20 09:00:00,41551.3,-140.4,607491.4600000014,507491.4600000013
2024-01-20 09:15:00,41510.8,2024-01-20 19:00:00,41629.8,-119.0,607372.4600000014,507372.4600000013
2024-01-20 19:15:00,41669.5,2024-01-21 00:15:00,41692.1,22.6,607395.0600000012,507395.0600000013
2024-01-21 00:30:00,41643.1,2024-01-21 07:45:00,41648.6,-5.5,607389.5600000012,507389.5600000013
2024-01-21 08:00:00,41693.7,2024-01-21 15:15:00,41730.1,36.4,607425.9600000014,507425.9600000013
2024-01-21 15:30:00,41627.4,2024-01-21 19:30:00,41680.3,-52.9,607373.0600000012,507373.0600000013
2024-01-21 19:45:00,41721.2,2024-01-21 22:45:00,41636.7,-84.5,607288.5600000012,507288.5600000013
2024-01-21 23:00:00,41580.0,2024-01-22 05:15:00,41002.9,577.1,607865.6600000013,507865.66000000125
2024-01-22 05:30:00,41119.9,2024-01-22 08:15:00,40903.3,-216.6,607649.0600000012,507649.0600000013
2024-01-22 08:30:00,40811.0,2024-01-22 12:30:00,40858.0,-47.0,607602.0600000012,507602.0600000013
2024-01-22 12:45:00,40885.6,2024-01-22 14:00:00,40794.3,-91.3,607510.7600000013,507510.7600000013
2024-01-22 14:15:00,40595.5,2024-01-23 02:15:00,39933.9,661.6,608172.3600000013,508172.36000000127
2024-01-23 02:30:00,40019.9,2024-01-23 07:00:00,39937.6,-82.3,608090.0600000012,508090.0600000013
2024-01-23 07:15:00,39802.4,2024-01-23 15:15:00,39049.0,753.4,608843.4600000014,508843.4600000013
2024-01-23 15:30:00,39290.0,2024-01-24 02:45:00,39759.3,469.3,609312.7600000013,509312.7600000013
2024-01-24 03:00:00,39750.5,2024-01-24 07:00:00,39920.5,-170.0,609142.7600000013,509142.7600000013
2024-01-24 07:15:00,40095.8,2024-01-24 12:30:00,40196.4,100.6,609243.3600000013,509243.36000000127
2024-01-24 12:45:00,40030.4,2024-01-24 22:45:00,39872.5,157.9,609401.2600000013,509401.2600000013
2024-01-24 23:00:00,39991.0,2024-01-25 04:45:00,39949.4,-41.6,609359.6600000013,509359.6600000013
2024-01-25 05:00:00,39828.5,2024-01-25 07:00:00,39989.5,-161.0,609198.6600000013,509198.6600000013
2024-01-25 07:15:00,40087.4,2024-01-25 12:15:00,39999.2,-88.2,609110.4600000014,509110.4600000013
2024-01-25 12:30:00,39901.9,2024-01-25 19:30:00,39931.4,-29.5,609080.9600000014,509080.9600000013
2024-01-25 19:45:00,39982.9,2024-01-26 06:30:00,40072.9,90.0,609170.9600000014,509170.9600000013
2024-01-26 06:45:00,39993.0,2024-01-26 08:00:00,40085.0,-92.0,609078.9600000014,509078.9600000013
2024-01-26 08:15:00,40152.3,2024-01-26 16:45:00,41978.03,1825.73,610904.6900000013,510904.6900000013
2024-01-26 23:45:00,41806.4,2024-01-27 09:45:00,41656.4,150.0,611054.6900000013,511054.6900000013
2024-01-27 10:00:00,41784.8,2024-01-28 00:00:00,42089.7,304.9,611359.5900000012,511359.5900000013
2024-01-28 00:15:00,41949.3,2024-01-28 01:15:00,42162.6,-254.98,611104.6100000013,511104.6100000013
2024-01-28 03:45:00,42210.0,2024-01-28 05:45:00,42538.1,328.1,611432.7100000014,511432.7100000013
2024-01-28 06:00:00,42385.3,2024-01-28 23:15:00,41935.0,450.3,611883.0100000013,511883.0100000013
2024-01-28 23:30:00,42031.3,2024-01-29 05:15:00,42193.9,162.6,612045.6100000013,512045.61000000127
2024-01-29 05:30:00,42140.8,2024-01-29 09:30:00,42228.0,-87.2,611958.4100000013,511958.41000000125
2024-01-29 09:45:00,42279.6,2024-01-29 12:15:00,42225.1,-54.5,611903.9100000013,511903.91000000125
2024-01-29 12:30:00,42022.6,2024-01-29 15:30:00,42082.7,-60.1,611843.8100000012,511843.8100000013
2024-01-29 15:45:00,42623.2,2024-01-29 15:45:00,42623.2,-494.34,611349.4700000013,511349.47000000125
2024-01-30 04:30:00,43402.0,2024-01-30 10:30:00,43431.2,-29.2,611320.2700000012,511320.27000000124
2024-01-30 10:45:00,43464.1,2024-01-30 12:15:00,43392.9,-71.2,611249.0700000012,511249.07000000123
2024-01-30 12:30:00,43336.0,2024-01-30 19:30:00,43384.2,-48.2,611200.8700000013,511200.8700000012
2024-01-30 19:45:00,43525.1,2024-01-30 22:30:00,43451.2,-73.9,611126.9700000011,511126.9700000012
2024-01-30 22:45:00,43306.0,2024-01-31 05:15:00,42915.4,390.6,611517.5700000012,511517.5700000012
2024-01-31 05:30:00,42990.9,2024-01-31 09:00:00,42824.0,-166.9,611350.6700000011,511350.67000000115
2024-01-31 09:15:00,42766.9,2024-01-31 13:30:00,42678.9,88.0,611438.6700000011,511438.67000000115
2024-01-31 13:45:00,42788.0,2024-01-31 19:00:00,43374.7,586.7,612025.3700000012,512025.37000000116
2024-01-31 19:15:00,43154.5,2024-02-01 07:15:00,42222.1,932.4,612957.7700000012,512957.7700000012
2024-02-01 07:30:00,42265.1,2024-02-02 02:00:00,43149.5,884.4,613842.1700000012,513842.1700000012
2024-02-02 02:15:00,43017.8,2024-02-02 06:00:00,43096.6,-78.8,613763.3700000013,513763.3700000012
2024-02-02 06:15:00,43193.3,2024-02-02 08:15:00,43022.3,-171.0,613592.3700000013,513592.3700000012
2024-02-02 08:30:00,42988.7,2024-02-02 12:00:00,43155.5,-166.8,613425.5700000012,513425.57000000123
2024-02-02 12:15:00,43202.0,2024-02-02 13:15:00,43068.0,-134.0,613291.5700000012,513291.57000000123
2024-02-02 13:30:00,42825.8,2024-02-02 14:45:00,42787.9,37.9,613329.4700000013,513329.47000000125
2024-02-02 15:00:00,43069.1,2024-02-02 17:15:00,43212.0,142.9,613472.3700000013,513472.3700000013
2024-02-02 17:30:00,42980.7,2024-02-02 22:00:00,43013.3,-32.6,613439.7700000013,513439.7700000013
2024-02-02 22:15:00,43130.8,2024-02-03 04:45:00,43172.3,41.5,613481.2700000013,513481.2700000013
2024-02-03 05:00:00,43152.9,2024-02-03 15:00:00,42949.4,203.5,613684.7700000013,513684.7700000013
2024-02-03 15:15:00,43093.0,2024-02-03 19:15:00,43036.9,-56.1,613628.6700000013,513628.6700000013
2024-02-03 19:30:00,43013.7,2024-02-04 03:15:00,43019.7,-6.0,613622.6700000013,513622.6700000013
2024-02-04 03:30:00,43024.0,2024-02-04 04:45:00,42902.0,-145.42,613477.2500000014,513477.25000000134
2024-02-04 05:45:00,42875.0,2024-02-04 09:30:00,42904.8,-29.8,613447.4500000014,513447.45000000135
2024-02-04 09:45:00,42920.8,2024-02-04 14:30:00,42939.0,18.2,613465.6500000013,513465.65000000136
2024-02-04 14:45:00,42855.3,2024-02-04 20:30:00,42650.2,205.1,613670.7500000014,513670.75000000134
2024-02-04 20:45:00,42868.7,2024-02-04 22:00:00,42794.5,-74.2,613596.5500000013,513596.5500000013
2024-02-04 22:15:00,42630.1,2024-02-04 22:45:00,42554.2,75.9,613672.4500000014,513672.45000000135
2024-02-04 23:00:00,42599.9,2024-02-05 14:30:00,43283.4,683.5,614355.9500000014,514355.95000000135
2024-02-05 14:45:00,43184.4,2024-02-05 23:30:00,42675.7,508.7,614864.6500000013,514864.65000000136
2024-02-05 23:45:00,42692.9,2024-02-06 10:45:00,42784.2,91.3,614955.9500000014,514955.95000000135
2024-02-06 11:00:00,42741.7,2024-02-06 14:15:00,42890.8,-149.1,614806.8500000014,514806.8500000014
2024-02-06 14:30:00,43005.4,2024-02-06 23:30:00,43106.1,100.7,614907.5500000014,514907.5500000014
2024-02-06 23:45:00,43079.1,2024-02-07 05:30:00,42962.8,116.3,615023.8500000014,515023.8500000014
2024-02-07 05:45:00,43009.9,2024-02-07 10:30:00,43044.3,34.4,615058.2500000014,515058.2500000014
2024-02-07 10:45:00,42882.5,2024-02-07 12:45:00,43056.5,-174.0,614884.2500000014,514884.2500000014
2024-02-07 13:00:00,43075.0,2024-02-08 00:00:00,44377.72,1302.72,616186.9700000014,516186.97000000137
2024-02-08 06:45:00,44449.9,2024-02-08 08:30:00,44683.9,-234.0,615952.9700000014,515952.97000000137
2024-02-08 08:45:00,44695.5,2024-02-09 02:45:00,46313.53,1618.03,617571.0000000014,517571.0000000014
2024-02-09 05:00:00,45926.6,2024-02-09 07:30:00,46295.7,-431.16,617139.8400000015,517139.8400000014
2024-02-09 08:15:00,46466.4,2024-02-09 20:45:00,47487.3,1020.9,618160.7400000014,518160.74000000145
2024-02-09 21:00:00,47357.5,2024-02-10 03:00:00,47426.3,-68.8,618091.9400000015,518091.94000000146
2024-02-10 03:15:00,47453.5,2024-02-10 07:30:00,47257.7,-195.8,617896.1400000015,517896.14000000147
2024-02-10 07:45:00,47130.5,2024-02-10 11:45:00,47172.8,-42.3,617853.8400000015,517853.8400000015
2024-02-10 12:00:00,47241.4,2024-02-10 22:00:00,47785.4,544.0,618397.8400000015,518397.8400000015
2024-02-10 22:15:00,47654.5,2024-02-11 03:00:00,47919.8,-265.3,618132.5400000014,518132.5400000015
2024-02-11 03:15:00,48068.4,2024-02-11 07:15:00,48219.7,151.3,618283.8400000015,518283.8400000015
2024-02-11 07:30:00,48089.9,2024-02-11 11:00:00,48176.7,-86.8,618197.0400000014,518197.0400000015
2024-02-11 11:15:00,48355.0,2024-02-11 13:45:00,48053.3,-301.7,617895.3400000015,517895.3400000015
2024-02-11 14:00:00,47966.8,2024-02-11 19:30:00,48322.4,-424.42,617470.9200000016,517470.9200000015
2024-02-11 20:15:00,48339.7,2024-02-12 02:00:00,48407.4,67.7,617538.6200000015,517538.6200000015
2024-02-12 02:15:00,48322.3,2024-02-12 06:45:00,48147.2,175.1,617713.7200000015,517713.7200000015
2024-02-12 07:00:00,48193.5,2024-02-12 09:15:00,48074.0,-119.5,617594.2200000015,517594.2200000015
2024-02-12 09:30:00,47954.1,2024-02-12 13:45:00,47948.8,5.3,617599.5200000014,517599.5200000015
2024-02-12 14:00:00,48106.5,2024-02-12 19:30:00,49741.6,1635.1,619234.6200000015,519234.62000000145
2024-02-12 19:45:00,49545.9,2024-02-12 20:45:00,50177.6,-631.7,618602.9200000014,518602.92000000144
2024-02-12 21:00:00,50286.7,2024-02-13 03:15:00,49905.5,-381.2,618221.7200000014,518221.7200000014
2024-02-13 03:30:00,49800.3,2024-02-13 08:15:00,50099.0,-298.7,617923.0200000014,517923.0200000014
2024-02-13 08:30:00,50156.9,2024-02-13 10:30:00,49969.5,-187.4,617735.6200000014,517735.6200000014
2024-02-13 10:45:00,49877.4,2024-02-13 18:00:00,48988.9,888.5,618624.1200000014,518624.1200000014
2024-02-13 18:15:00,49198.2,2024-02-14 09:00:00,51591.02,2392.82,621016.9400000013,521016.9400000014
2024-02-15 01:30:00,51857.8,2024-02-15 03:15:00,52304.1,-446.3,620570.6400000014,520570.6400000014
2024-02-15 03:30:00,52362.9,2024-02-15 07:15:00,52091.3,-271.6,620299.0400000014,520299.04000000143
2024-02-15 07:30:00,51751.9,2024-02-15 09:15:00,52106.0,-548.57,619750.4700000014,519750.4700000014
2024-02-15 09:30:00,52208.4,2024-02-15 15:15:00,52240.8,32.4,619782.8700000015,519782.87000000145
2024-02-15 15:30:00,51981.7,2024-02-15 23:45:00,51898.5,83.2,619866.0700000015,519866.07000000146
2024-02-16 00:00:00,51946.6,2024-02-16 06:30:00,52036.3,89.7,619955.7700000014,519955.7700000015
2024-02-16 06:45:00,51930.0,2024-02-16 10:15:00,51969.3,-39.3,619916.4700000015,519916.4700000015
2024-02-16 10:30:00,52102.7,2024-02-16 14:45:00,51952.1,-150.6,619765.8700000015,519765.8700000015
2024-02-16 15:00:00,51682.7,2024-02-16 23:00:00,52020.0,-337.3,619428.5700000015,519428.5700000015
2024-02-16 23:15:00,52121.2,2024-02-17 03:00:00,51958.8,-162.4,619266.1700000016,519266.1700000015
2024-02-17 03:15:00,51920.6,2024-02-17 17:15:00,51112.8,807.8,620073.9700000015,520073.9700000015
2024-02-17 17:30:00,51207.9,2024-02-17 23:45:00,51679.4,471.5,620545.4700000015,520545.4700000015
2024-02-18 00:00:00,51679.3,2024-02-18 04:00:00,51588.3,91.0,620636.4700000015,520636.4700000015
2024-02-18 04:15:00,51651.2,2024-02-18 12:15:00,51858.1,206.9,620843.3700000015,520843.3700000015
2024-02-18 12:30:00,51776.5,2024-02-18 14:30:00,51878.2,-101.7,620741.6700000016,520741.6700000015
2024-02-18 14:45:00,51919.3,2024-02-19 03:15:00,52092.4,173.1,620914.7700000014,520914.7700000015
2024-02-19 03:30:00,52014.8,2024-02-19 06:00:00,52391.0,-376.2,620538.5700000015,520538.57000000146
2024-02-19 06:15:00,52455.8,2024-02-19 08:30:00,52252.2,-203.6,620334.9700000015,520334.9700000015
2024-02-19 08:45:00,52121.5,2024-02-20 04:15:00,51763.1,358.4,620693.3700000015,520693.3700000015
2024-02-20 04:30:00,51845.5,2024-02-20 09:00:00,51750.1,-95.4,620597.9700000015,520597.9700000015
2024-02-20 09:15:00,51642.3,2024-02-20 10:00:00,51984.7,-342.4,620255.5700000015,520255.57000000146
2024-02-20 10:15:00,52036.3,2024-02-20 13:45:00,52890.0,853.7,621109.2700000014,521109.2700000015
2024-02-20 14:00:00,52290.0,2024-02-20 19:00:00,51531.1,758.9,621868.1700000016,521868.1700000015
2024-02-20 19:15:00,51752.3,2024-02-21 02:30:00,52128.2,375.9,622244.0700000015,522244.0700000015
2024-02-21 02:45:00,52102.1,2024-02-21 12:00:00,51120.6,981.5,623225.5700000015,523225.5700000015
2024-02-21 12:15:00,51250.8,2024-02-22 01:15:00,51592.5,341.7,623567.2700000015,523567.27000000153
2024-02-22 01:30:00,51402.4,2024-02-22 03:45:00,51612.1,-209.7,623357.5700000015,523357.5700000015
2024-02-22 04:00:00,51645.4,2024-02-22 11:00:00,51691.4,46.0,623403.5700000015,523403.5700000015
2024-02-22 11:15:00,51665.9,2024-02-22 15:15:00,51400.6,265.3,623668.8700000015,523668.8700000015
2024-02-22 15:30:00,51597.2,2024-02-22 22:00:00,51618.5,21.3,623690.1700000016,523690.1700000015
2024-02-22 22:15:00,51231.3,2024-02-23 11:15:00,51188.0,43.3,623733.4700000015,523733.4700000015
2024-02-23 11:30:00,51255.9,2024-02-23 15:45:00,50938.1,-317.8,623415.6700000016,523415.6700000015
2024-02-23 16:00:00,50726.2,2024-02-23 18:15:00,51183.5,-457.3,622958.3700000015,522958.3700000015
2024-02-23 18:30:00,51194.7,2024-02-23 22:30:00,50859.0,-335.7,622622.6700000016,522622.6700000015
2024-02-23 22:45:00,50808.1,2024-02-24 00:30:00,50900.9,-92.8,622529.8700000015,522529.8700000015
2024-02-24 00:45:00,50917.2,2024-02-24 17:30:00,51636.95,719.75,623249.6200000015,523249.6200000015
2024-02-25 00:30:00,51484.4,2024-02-25 01:45:00,51718.8,-234.4,623015.2200000015,523015.2200000015
2024-02-25 02:00:00,51814.5,2024-02-25 02:45:00,51633.1,-181.4,622833.8200000015,522833.82000000146
2024-02-25 03:00:00,51577.3,2024-02-25 06:00:00,51699.9,-122.6,622711.2200000015,522711.2200000015
2024-02-25 06:15:00,51780.1,2024-02-25 10:30:00,51626.9,-153.2,622558.0200000014,522558.0200000015
2024-02-25 10:45:00,51608.8,2024-02-25 18:15:00,51554.2,54.6,622612.6200000015,522612.62000000145
2024-02-25 18:30:00,51591.0,2024-02-25 23:45:00,51764.9,173.9,622786.5200000014,522786.5200000015
2024-02-26 00:00:00,51677.2,2024-02-26 12:30:00,51214.5,462.7,623249.2200000015,523249.2200000015
2024-02-26 12:45:00,51275.6,2024-02-26 16:00:00,53533.97,2258.37,625507.5900000015,525507.5900000015
2024-02-27 02:15:00,56477.5,2024-02-27 08:15:00,56402.2,75.3,625582.8900000015,525582.8900000015
2024-02-27 08:30:00,56450.1,2024-02-27 21:30:00,56852.3,402.2,625985.0900000015,525985.0900000015
2024-02-27 21:45:00,56755.8,2024-02-28 04:00:00,57024.6,-268.8,625716.2900000014,525716.2900000014
2024-02-28 04:15:00,57122.9,2024-02-28 11:15:00,59545.0,2422.1,628138.3900000014,528138.3900000014
2024-02-28 18:00:00,60835.1,2024-02-28 22:00:00,61164.3,-329.2,627809.1900000015,527809.1900000015
2024-02-28 22:15:00,61410.5,2024-02-29 13:00:00,62833.9,1423.4,629232.5900000015,529232.5900000015
2024-02-29 13:15:00,62283.9,2024-02-29 19:45:00,61681.8,602.1,629834.6900000015,529834.6900000015
2024-02-29 20:00:00,62019.4,2024-02-29 22:15:00,61072.6,-946.8,628887.8900000014,528887.8900000014
2024-02-29 22:30:00,60734.7,2024-03-01 04:30:00,61378.7,-644.0,628243.8900000014,528243.8900000014
2024-03-01 04:45:00,61613.1,2024-03-01 15:15:00,61940.1,327.0,628570.8900000014,528570.8900000014
2024-03-01 15:30:00,61675.6,2024-03-01 18:00:00,62062.1,-386.5,628184.3900000014,528184.3900000014
2024-03-01 18:15:00,62310.0,2024-03-01 23:45:00,62430.6,120.6,628304.9900000014,528304.9900000014
2024-03-02 00:00:00,62375.0,2024-03-02 18:30:00,62023.9,351.1,628656.0900000014,528656.0900000014
2024-03-02 18:45:00,62099.9,2024-03-02 22:15:00,61938.1,-161.8,628494.2900000013,528494.2900000013
2024-03-02 22:30:00,61867.7,2024-03-03 03:15:00,62023.7,-156.0,628338.2900000013,528338.2900000013
2024-03-03 03:30:00,62048.5,2024-03-03 07:00:00,61949.6,-98.9,628239.3900000013,528239.3900000013
2024-03-03 07:15:00,61635.2,2024-03-03 08:45:00,61662.3,-27.1,628212.2900000013,528212.2900000013
2024-03-03 09:00:00,61889.0,2024-03-04 00:30:00,64323.51,2434.51,630646.8000000013,530646.8000000013
2024-03-04 05:15:00,63476.0,2024-03-04 07:15:00,63812.0,-336.0,630310.8000000013,530310.8000000013
2024-03-04 07:30:00,64195.7,2024-03-04 23:00:00,68485.19,4289.49,634600.2900000013,534600.2900000013
2024-03-05 05:00:00,66649.4,2024-03-05 05:00:00,66649.4,0.0,634600.2900000013,534600.2900000013
2024-03-05 05:15:00,66950.0,2024-03-05 15:00:00,68423.0,1473.0,636073.2900000013,536073.2900000013
2024-03-05 15:15:00,67270.1,2024-03-05 19:45:00,61510.2,5759.9,641833.1900000013,541833.1900000013
2024-03-05 20:00:00,63107.8,2024-03-06 12:00:00,67676.8,4569.0,646402.1900000013,546402.1900000013
2024-03-06 12:30:00,66039.2,2024-03-06 13:45:00,66394.1,-354.9,646047.2900000013,546047.2900000013
2024-03-06 14:00:00,66950.0,2024-03-06 22:15:00,66526.9,-423.1,645624.1900000013,545624.1900000013
2024-03-06 22:30:00,66159.0,2024-03-07 07:45:00,66447.8,-288.8,645335.3900000013,545335.3900000013
2024-03-07 08:00:00,66838.6,2024-03-07 22:15:00,67431.1,592.5,645927.8900000013,545927.8900000013
2024-03-07 22:30:00,67116.2,2024-03-08 06:30:00,67256.4,-140.2,645787.6900000013,545787.6900000013
2024-03-08 06:45:00,67634.0,2024-03-08 08:00:00,67248.9,-385.1,645402.5900000014,545402.5900000014
2024-03-08 08:15:00,67093.1,2024-03-08 11:30:00,67600.0,-506.9,644895.6900000013,544895.6900000013
2024-03-08 11:45:00,67822.0,2024-03-08 15:30:00,68313.3,491.3,645386.9900000014,545386.9900000014
2024-03-08 15:45:00,67685.8,2024-03-08 17:00:00,67982.2,-296.4,645090.5900000014,545090.5900000014
2024-03-08 17:15:00,68319.8,2024-03-08 23:15:00,68246.5,-73.3,645017.2900000013,545017.2900000013
2024-03-08 23:30:00,68121.3,2024-03-09 06:15:00,68335.2,-213.9,644803.3900000013,544803.3900000013
2024-03-09 06:30:00,68443.0,2024-03-09 10:00:00,68263.9,-179.1,644624.2900000013,544624.2900000013
2024-03-09 10:15:00,68113.8,2024-03-09 12:30:00,68399.9,-286.1,644338.1900000013,544338.1900000013
2024-03-09 12:45:00,68524.8,2024-03-09 16:15:00,68184.6,-340.2,643997.9900000014,543997.9900000014
2024-03-09 16:30:00,68146.1,2024-03-09 20:45:00,68395.0,-248.9,643749.0900000014,543749.0900000014
2024-03-09 21:00:00,68424.3,2024-03-10 14:15:00,69333.2,908.9,644657.9900000014,544657.9900000014
2024-03-10 14:30:00,68944.9,2024-03-10 16:00:00,69492.4,-547.5,644110.4900000014,544110.4900000014
2024-03-10 16:15:00,69699.9,2024-03-10 21:00:00,69387.0,-312.9,643797.5900000014,543797.5900000014
2024-03-10 21:15:00,69201.9,2024-03-10 23:30:00,68821.1,380.8,644178.3900000014,544178.3900000014
2024-03-10 23:45:00,69001.8,2024-03-11 00:45:00,68149.9,-1065.36,643113.0300000014,543113.0300000014
2024-03-11 01:30:00,67881.0,2024-03-11 03:30:00,68538.0,-657.0,642456.0300000014,542456.0300000014
2024-03-11 03:45:00,68657.4,2024-03-11 11:30:00,72098.6,3441.2,645897.2300000014,545897.2300000014
2024-03-12 00:45:00,72068.4,2024-03-12 06:30:00,71725.9,342.5,646239.7300000014,546239.7300000014
2024-03-12 06:45:00,72331.0,2024-03-12 14:15:00,72135.9,-195.1,646044.6300000014,546044.6300000014
2024-03-12 14:30:00,71886.1,2024-03-12 17:30:00,70217.3,1668.8,647713.4300000014,547713.4300000014
2024-03-12 17:45:00,71161.2,2024-03-13 11:15:00,73548.81,2387.61,650101.0400000014,550101.0400000014
2024-03-13 12:30:00,72814.3,2024-03-13 16:30:00,72818.8,-4.5,650096.5400000014,550096.5400000014
2024-03-13 16:45:00,73058.8,2024-03-14 04:45:00,73008.7,-50.1,650046.4400000015,550046.4400000015
2024-03-14 05:00:00,72818.0,2024-03-14 06:00:00,73437.1,-619.1,649427.3400000015,549427.3400000015
2024-03-14 06:15:00,73644.6,2024-03-14 10:15:00,73309.1,-335.5,649091.8400000015,549091.8400000015
2024-03-14 10:30:00,73133.3,2024-03-14 20:15:00,70610.3,2523.0,651614.8400000015,551614.8400000015
2024-03-14 20:30:00,70937.0,2024-03-15 02:00:00,71573.9,636.9,652251.7400000015,552251.7400000015
2024-03-15 02:15:00,70758.5,2024-03-15 07:15:00,68315.2,2443.3,654695.0400000016,554695.0400000016
2024-03-15 07:30:00,68754.1,2024-03-15 08:45:00,67122.6,-1631.5,653063.5400000016,553063.5400000016
2024-03-15 09:00:00,66165.0,2024-03-15 11:30:00,67531.1,-1366.1,651697.4400000016,551697.4400000016
2024-03-15 11:45:00,67818.3,2024-03-15 19:45:00,69003.0,1184.7,652882.1400000015,552882.1400000015
2024-03-15 20:00:00,67932.0,2024-03-15 22:30:00,68950.0,-1018.0,651864.1400000015,551864.1400000015
2024-03-15 22:45:00,69123.7,2024-03-16 04:15:00,69218.1,94.4,651958.5400000016,551958.5400000016
2024-03-16 04:30:00,68986.0,2024-03-16 07:15:00,69346.8,-360.8,651597.7400000015,551597.7400000015
2024-03-16 07:30:00,69479.3,2024-03-16 09:45:00,68995.0,-484.3,651113.4400000015,551113.4400000015
2024-03-16 10:00:00,68778.6,2024-03-17 02:00:00,66175.2,2603.4,653716.8400000015,553716.8400000015
2024-03-17 02:15:00,66471.9,2024-03-17 06:30:00,65714.8,-757.1,652959.7400000015,552959.7400000015
2024-03-17 06:45:00,65007.0,2024-03-17 08:15:00,65845.5,-838.5,652121.2400000015,552121.2400000015
2024-03-17 08:30:00,66361.3,2024-03-17 22:30:00,68909.68,2548.38,654669.6200000015,554669.6200000015
2024-03-18 00:00:00,67932.9,2024-03-18 02:45:00,67817.5,115.4,654785.0200000015,554785.0200000015
2024-03-18 03:00:00,68054.8,2024-03-18 07:45:00,68262.9,208.1,654993.1200000015,554993.1200000015
2024-03-18 08:00:00,68010.1,2024-03-18 11:00:00,68197.0,-186.9,654806.2200000015,554806.2200000015
2024-03-18 11:15:00,68449.5,2024-03-18 13:45:00,67605.8,-1202.43,653603.7900000014,553603.7900000014
2024-03-18 14:15:00,67424.5,2024-03-18 21:00:00,67577.9,-153.4,653450.3900000014,553450.3900000014
2024-03-18 21:15:00,67699.0,2024-03-19 00:45:00,67146.9,-552.1,652898.2900000014,552898.2900000014
2024-03-19 01:00:00,66870.9,2024-03-19 15:45:00,64084.0,2786.9,655685.1900000015,555685.1900000015
2024-03-19 16:00:00,64359.7,2024-03-19 19:45:00,64435.0,75.3,655760.4900000015,555760.4900000015
2024-03-19 20:00:00,63835.7,2024-03-20 03:00:00,62901.0,934.7,656695.1900000015,556695.1900000015
2024-03-20 03:15:00,63426.2,2024-03-20 04:15:00,61868.0,-1558.2,655136.9900000015,555136.9900000015
2024-03-20 04:30:00,61357.5,2024-03-20 07:00:00,62209.9,-852.4,654284.5900000015,554284.5900000015
2024-03-20 07:15:00,62657.2,2024-03-20 16:00:00,63736.0,1078.8,655363.3900000015,555363.3900000015
2024-03-20 16:15:00,62675.0,2024-03-20 17:00:00,63700.1,-1025.1,654338.2900000016,554338.2900000016
2024-03-20 17:15:00,64128.8,2024-03-21 02:15:00,67915.82,3787.02,658125.3100000016,558125.3100000016
2024-03-21 03:30:00,67023.5,2024-03-21 07:00:00,67034.4,-10.9,658114.4100000015,558114.4100000015
2024-03-21 07:15:00,67323.8,2024-03-21 14:45:00,66915.8,-408.0,657706.4100000015,557706.4100000015
2024-03-21 15:00:00,66368.8,2024-03-21 23:45:00,65539.9,828.9,658535.3100000016,558535.3100000016
2024-03-22 00:00:00,65825.8,2024-03-22 08:30:00,65980.7,154.9,658690.2100000016,558690.2100000016
2024-03-22 08:45:00,65900.0,2024-03-22 19:15:00,63653.9,2246.1,660936.3100000016,560936.3100000016
2024-03-22 19:30:00,63897.6,2024-03-22 21:15:00,63125.9,-771.7,660164.6100000016,560164.6100000016
2024-03-22 21:30:00,62707.2,2024-03-22 23:15:00,63385.8,-678.6,659486.0100000016,559486.0100000016
2024-03-22 23:30:00,63479.3,2024-03-23 03:15:00,63475.9,-3.4,659482.6100000016,559482.6100000016
2024-03-23 03:30:00,63390.1,2024-03-23 04:15:00,63939.1,-549.0,658933.6100000016,558933.6100000016
2024-03-23 04:30:00,64028.5,2024-03-23 19:00:00,65408.0,1379.5,660313.1100000016,560313.1100000016
2024-03-23 19:15:00,65168.1,2024-03-24 07:30:00,64436.5,731.6,661044.7100000016,561044.7100000016
2024-03-24 07:45:00,64624.6,2024-03-24 16:45:00,65296.0,671.4,661716.1100000016,561716.1100000016
2024-03-24 17:00:00,64916.1,2024-03-24 18:00:00,65622.2,-706.1,661010.0100000016,561010.0100000016
2024-03-24 18:15:00,65736.0,2024-03-25 00:30:00,66688.1,952.1,661962.1100000016,561962.1100000016
2024-03-25 00:45:00,66633.6,2024-03-25 03:30:00,67099.1,-465.5,661496.6100000016,561496.6100000016
2024-03-25 03:45:00,67407.8,2024-03-25 07:30:00,67061.0,-346.8,661149.8100000016,561149.8100000016
2024-03-25 07:45:00,66866.6,2024-03-25 13:30:00,67232.7,-366.1,660783.7100000016,560783.7100000016
2024-03-25 13:45:00,68046.6,2024-03-25 13:45:00,68046.6,-884.4,659899.3100000016,559899.3100000016
2024-03-25 21:15:00,69866.3,2024-03-26 02:30:00,70296.9,-430.6,659468.7100000016,559468.7100000016
2024-03-26 02:45:00,70588.3,2024-03-26 07:30:00,71195.1,606.8,660075.5100000016,560075.5100000016
2024-03-26 07:45:00,70535.0,2024-03-26 12:30:00,71050.0,-515.0,659560.5100000016,559560.5100000016
2024-03-26 12:45:00,71168.1,2024-03-26 13:30:00,70609.3,-901.31,658659.2000000016,558659.2000000016
2024-03-26 14:15:00,69633.7,2024-03-26 22:30:00,70085.0,-451.3,658207.9000000015,558207.9000000015
2024-03-26 22:45:00,70304.5,2024-03-27 06:45:00,70371.0,66.5,658274.4000000015,558274.4000000015
2024-03-27 07:00:00,70106.7,2024-03-27 10:00:00,70102.7,4.0,658278.4000000015,558278.4000000015
2024-03-27 10:15:00,70262.6,2024-03-27 13:30:00,70624.8,362.2,658640.6000000015,558640.6000000015
2024-03-27 13:45:00,69966.2,2024-03-27 22:15:00,69376.9,589.3,659229.9000000015,559229.9000000015
2024-03-27 22:30:00,69441.5,2024-03-28 02:15:00,69505.4,63.9,659293.8000000016,559293.8000000016
2024-03-28 02:30:00,69036.4,2024-03-28 04:30:00,69746.3,-709.9,658583.9000000015,558583.9000000015
2024-03-28 04:45:00,69781.0,2024-03-28 18:30:00,70784.2,1003.2,659587.1000000015,559587.1000000015
2024-03-28 18:45:00,70610.4,2024-03-28 22:45:00,70907.6,-297.2,659289.9000000015,559289.9000000015
2024-03-28 23:00:00,71106.6,2024-03-29 03:00:00,70720.3,-386.3,658903.6000000015,558903.6000000015
2024-03-29 03:15:00,70349.3,2024-03-29 11:00:00,70195.2,154.1,659057.7000000015,559057.7000000015
2024-03-29 11:15:00,70285.1,2024-03-29 15:00:00,70100.1,-185.0,658872.7000000015,558872.7000000015
2024-03-29 15:15:00,69979.5,2024-03-29 19:30:00,69604.6,374.9,659247.6000000015,559247.6000000015
2024-03-29 19:45:00,69720.6,2024-03-30 07:30:00,70034.4,313.8,659561.4000000015,559561.4000000015
2024-03-30 07:45:00,69900.1,2024-03-30 11:30:00,70178.5,-278.4,659283.0000000015,559283.0000000015
2024-03-30 11:45:00,70237.1,2024-03-30 17:45:00,70100.0,-137.1,659145.9000000015,559145.9000000015
2024-03-30 18:00:00,69986.6,2024-03-31 00:45:00,69923.6,63.0,659208.9000000015,559208.9000000015
2024-03-31 01:00:00,70028.4,2024-04-01 01:30:00,70923.9,895.5,660104.4000000015,560104.4000000015
2024-04-01 01:45:00,70885.1,2024-04-01 06:45:00,69651.7,1233.4,661337.8000000016,561337.8000000016
2024-04-01 07:00:00,69745.8,2024-04-01 14:15:00,69443.9,-301.9,661035.9000000015,561035.9000000015
2024-04-01 14:30:00,69084.4,2024-04-01 18:45:00,68960.9,123.5,661159.4000000015,561159.4000000015
2024-04-01 19:00:00,69105.8,2024-04-02 02:00:00,69294.1,188.3,661347.7000000016,561347.7000000016
2024-04-02 02:15:00,68491.3,2024-04-02 05:45:00,66794.0,1697.3,663045.0000000016,563045.0000000016
2024-04-02 06:00:00,66937.5,2024-04-02 09:00:00,66373.5,-1088.51,661956.4900000016,561956.4900000016
2024-04-02 10:00:00,66036.3,2024-04-02 14:00:00,65576.4,459.9,662416.3900000016,562416.3900000016
2024-04-02 14:15:00,65914.9,2024-04-02 23:45:00,65505.3,-409.6,662006.7900000017,562006.7900000017
2024-04-03 00:00:00,65382.6,2024-04-03 01:30:00,65496.8,-114.2,661892.5900000017,561892.5900000017
2024-04-03 01:45:00,65829.9,2024-04-03 10:45:00,66230.1,400.2,662292.7900000017,562292.7900000017
2024-04-03 11:00:00,65713.4,2024-04-03 13:45:00,65843.1,-129.7,662163.0900000017,562163.0900000017
2024-04-03 14:00:00,66666.0,2024-04-03 15:15:00,66318.2,-347.8,661815.2900000017,561815.2900000017
2024-04-03 15:30:00,65881.9,2024-04-03 22:15:00,66037.3,-155.4,661659.8900000016,561659.8900000016
2024-04-03 22:30:00,66193.0,2024-04-04 02:00:00,66076.0,-117.0,661542.8900000016,561542.8900000016
2024-04-04 02:15:00,65609.7,2024-04-04 06:15:00,65665.3,-55.6,661487.2900000017,561487.2900000017
2024-04-04 06:30:00,65750.1,2024-04-04 17:30:00,68163.05,2412.95,663900.2400000016,563900.2400000016
2024-04-04 20:00:00,67760.7,2024-04-04 23:00:00,68283.9,-523.2,663377.0400000017,563377.0400000017
2024-04-04 23:15:00,68340.5,2024-04-05 02:15:00,67913.8,-426.7,662950.3400000017,562950.3400000017
2024-04-05 02:30:00,67688.7,2024-04-05 07:45:00,66937.4,751.3,663701.6400000018,563701.6400000018
2024-04-05 08:00:00,67319.4,2024-04-05 09:00:00,67008.0,-311.4,663390.2400000017,563390.2400000017
2024-04-05 09:15:00,66660.0,2024-04-05 13:15:00,66918.0,-258.0,663132.2400000017,563132.2400000017
2024-04-05 13:30:00,67323.8,2024-04-05 17:30:00,67567.1,243.3,663375.5400000018,563375.5400000018
2024-04-05 17:45:00,67455.8,2024-04-06 04:45:00,67747.5,-291.7,663083.8400000018,563083.8400000018
2024-04-06 05:00:00,67955.9,2024-04-06 10:15:00,67817.3,-138.6,662945.2400000019,562945.2400000019
2024-04-06 10:30:00,67800.0,2024-04-06 14:30:00,67994.8,-194.8,662750.4400000018,562750.4400000018
2024-04-06 14:45:00,67981.9,2024-04-06 23:30:00,69076.0,1094.1,663844.5400000018,563844.5400000018
2024-04-06 23:45:00,68901.6,2024-04-07 02:00:00,69483.9,-805.76,663038.7800000018,563038.7800000018
2024-04-07 02:15:00,69652.0,2024-04-07 17:45:00,69826.4,174.4,663213.1800000018,563213.1800000018
2024-04-07 18:00:00,69581.9,2024-04-08 00:45:00,69350.1,231.8,663444.9800000018,563444.9800000018
2024-04-08 01:00:00,69558.4,2024-04-08 12:00:00,72702.79,3144.39,666589.3700000019,566589.3700000019
2024-04-08 14:15:00,71645.4,2024-04-08 22:30:00,71688.1,-42.7,666546.6700000019,566546.6700000019
2024-04-08 22:45:00,71973.1,2024-04-09 00:45:00,71470.0,-503.1,666043.5700000019,566043.5700000019
2024-04-09 01:00:00,71122.6,2024-04-09 02:45:00,71526.3,-403.7,665639.870000002,565639.870000002
2024-04-09 03:00:00,71640.1,2024-04-09 06:15:00,71194.9,-445.2,665194.670000002,565194.670000002
2024-04-09 06:30:00,70826.1,2024-04-09 08:45:00,70544.6,281.5,665476.170000002,565476.170000002
2024-04-09 09:00:00,70809.2,2024-04-09 13:30:00,70565.5,-243.7,665232.4700000021,565232.4700000021
2024-04-09 13:45:00,69979.8,2024-04-09 20:30:00,69090.0,889.8,666122.2700000021,566122.2700000021
2024-04-09 20:45:00,69220.2,2024-04-10 02:30:00,68794.5,-425.7,665696.5700000022,565696.5700000022
2024-04-10 02:45:00,68703.0,2024-04-10 04:45:00,69176.4,-473.4,665223.1700000021,565223.1700000021
2024-04-10 05:00:00,69315.0,2024-04-10 10:15:00,68890.7,-424.3,664798.8700000021,564798.8700000021
2024-04-10 10:30:00,68856.0,2024-04-10 14:15:00,68631.5,224.5,665023.3700000021,565023.3700000021
2024-04-10 14:30:00,68860.0,2024-04-11 00:00:00,70508.2,1648.2,666671.570000002,566671.570000002
2024-04-11 00:15:00,70433.5,2024-04-11 07:15:00,70968.1,-733.43,665938.140000002,565938.140000002
2024-04-11 08:30:00,71174.7,2024-04-11 10:30:00,70621.5,-553.2,665384.940000002,565384.940000002
2024-04-11 10:45:00,70521.7,2024-04-11 12:45:00,70906.6,-384.9,665000.040000002,565000.040000002
2024-04-11 13:00:00,70933.5,2024-04-11 13:15:00,70764.1,-169.4,664830.640000002,564830.640000002
2024-04-11 13:30:00,69865.8,2024-04-11 19:15:00,70350.8,-485.0,664345.640000002,564345.640000002
2024-04-11 19:30:00,70540.6,2024-04-11 22:45:00,70201.5,-339.1,664006.540000002,564006.540000002
2024-04-11 23:00:00,70094.1,2024-04-12 01:45:00,70330.1,-236.0,663770.540000002,563770.540000002
2024-04-12 02:00:00,70581.0,2024-04-12 09:00:00,70798.8,217.8,663988.3400000021,563988.3400000021
2024-04-12 09:15:00,70734.7,2024-04-12 18:30:00,65115.36,5619.34,669607.680000002,569607.680000002
2024-04-12 19:30:00,67115.9,2024-04-13 01:15:00,66599.9,-516.0,669091.680000002,569091.680000002
2024-04-13 01:30:00,66313.2,2024-04-13 03:00:00,66567.1,-253.9,668837.780000002,568837.780000002
2024-04-13 03:15:00,66811.5,2024-04-13 08:30:00,67311.8,500.3,669338.080000002,569338.080000002
2024-04-13 08:45:00,67209.2,2024-04-13 15:00:00,67475.4,-266.2,669071.8800000021,569071.8800000021
2024-04-13 15:15:00,67909.7,2024-04-13 16:45:00,67450.5,-459.2,668612.6800000021,568612.6800000021
2024-04-13 17:00:00,67065.2,2024-04-13 20:15:00,62092.3,4972.9,673585.5800000022,573585.5800000022
2024-04-13 20:30:00,62500.2,2024-04-14 02:00:00,63645.8,1145.6,674731.1800000021,574731.1800000021
2024-04-14 02:15:00,63498.8,2024-04-14 04:00:00,63676.4,-177.6,674553.5800000022,574553.5800000022
2024-04-14 04:15:00,64126.4,2024-04-14 17:00:00,63733.3,-393.1,674160.4800000022,574160.4800000022
2024-04-14 17:15:00,63100.0,2024-04-14 17:45:00,63849.8,-749.8,673410.6800000021,573410.6800000021
2024-04-14 18:00:00,64233.3,2024-04-14 21:15:00,63614.1,-619.2,672791.4800000022,572791.4800000022
2024-04-14 21:30:00,63447.2,2024-04-14 21:45:00,63652.7,-205.5,672585.9800000022,572585.9800000022
2024-04-14 22:00:00,64909.0,2024-04-15 03:45:00,65107.9,198.9,672784.8800000022,572784.8800000022
2024-04-15 04:00:00,64757.9,2024-04-15 05:45:00,65428.1,-670.2,672114.6800000023,572114.6800000023
2024-04-15 06:00:00,65599.3,2024-04-15 11:30:00,65989.3,390.0,672504.6800000023,572504.6800000023
2024-04-15 11:45:00,65848.6,2024-04-15 23:45:00,63392.7,2455.9,674960.5800000023,574960.5800000023
2024-04-16 00:00:00,63560.1,2024-04-16 03:45:00,62937.6,-622.5,674338.0800000023,574338.0800000023
2024-04-16 04:00:00,62495.2,2024-04-16 06:00:00,62815.8,-320.6,674017.4800000023,574017.4800000023
2024-04-16 06:15:00,62913.4,2024-04-16 10:00:00,63126.8,213.4,674230.8800000023,574230.8800000023
2024-04-16 10:15:00,61862.0,2024-04-16 10:15:00,61862.0,-1172.8,673058.0800000023,573058.0800000023
2024-04-16 11:45:00,63064.6,2024-04-16 15:30:00,61927.2,-1137.4,671920.6800000023,571920.6800000023
2024-04-16 15:45:00,61749.2,2024-04-16 17:15:00,62983.9,-1491.94,670428.7400000023,570428.7400000023
2024-04-16 20:15:00,62905.7,2024-04-17 06:45:00,63853.5,947.8,671376.5400000024,571376.5400000024
2024-04-17 07:00:00,63505.2,2024-04-17 17:45:00,61242.7,2262.5,673639.0400000024,573639.0400000024
2024-04-17 18:00:00,61622.1,2024-04-18 05:30:00,61334.1,-288.0,673351.0400000024,573351.0400000024
2024-04-18 05:45:00,61051.4,2024-04-18 10:00:00,61512.7,-461.3,672889.7400000023,572889.7400000023
2024-04-18 10:15:00,61620.5,2024-04-18 17:30:00,63168.0,1547.5,674437.2400000023,574437.2400000023
2024-04-18 17:45:00,62755.2,2024-04-18 20:00:00,63417.0,-661.8,673775.4400000023,573775.4400000023
2024-04-18 20:15:00,63440.7,2024-04-18 23:45:00,63445.0,4.3,673779.7400000023,573779.7400000023
2024-04-19 00:00:00,62890.8,2024-04-19 02:30:00,60254.7,2636.1,676415.8400000023,576415.8400000023
2024-04-19 02:45:00,61334.1,2024-04-19 11:30:00,65477.93,4143.83,680559.6700000023,580559.6700000023
2024-04-19 14:15:00,64000.0,2024-04-19 21:45:00,64378.9,-378.9,680180.7700000022,580180.7700000022
2024-04-19 22:00:00,64439.1,2024-04-19 23:00:00,63474.0,-1091.55,679089.2200000022,579089.2200000022
2024-04-20 08:00:00,63766.0,2024-04-20 13:00:00,63834.5,-68.5,679020.7200000022,579020.7200000022
2024-04-20 13:15:00,63911.8,2024-04-20 20:30:00,64741.0,829.2,679849.9200000021,579849.9200000021
2024-04-20 20:45:00,64690.7,2024-04-21 02:00:00,65003.3,-312.6,679537.3200000022,579537.3200000022
2024-04-21 02:15:00,65288.0,2024-04-21 04:00:00,64958.6,-329.4,679207.9200000021,579207.9200000021
2024-04-21 04:15:00,64938.0,2024-04-21 11:45:00,65203.5,-265.5,678942.4200000021,578942.4200000021
2024-04-21 12:00:00,65301.0,2024-04-21 15:45:00,65015.0,-286.0,678656.4200000021,578656.4200000021
2024-04-21 16:00:00,64486.6,2024-04-21 20:45:00,64621.5,-134.9,678521.5200000021,578521.5200000021
2024-04-21 21:00:00,64947.6,2024-04-22 01:15:00,64886.6,-61.0,678460.5200000021,578460.5200000021
2024-04-22 01:30:00,64760.7,2024-04-22 03:00:00,65065.5,-304.8,678155.7200000021,578155.7200000021
2024-04-22 03:15:00,65265.0,2024-04-22 11:15:00,65880.1,615.1,678770.820000002,578770.820000002
2024-04-22 11:30:00,65819.5,2024-04-22 14:00:00,66239.0,-419.5,678351.320000002,578351.320000002
2024-04-22 14:15:00,66433.1,2024-04-22 15:00:00,65725.6,-790.04,677561.280000002,577561.280000002
2024-04-23 02:45:00,66582.8,2024-04-23 13:15:00,66082.0,500.8,678062.080000002,578062.080000002
2024-04-23 13:30:00,66375.2,2024-04-23 19:15:00,66550.8,175.6,678237.680000002,578237.680000002
2024-04-23 19:30:00,66482.7,2024-04-23 23:45:00,66386.3,96.4,678334.080000002,578334.080000002
2024-04-24 00:00:00,66565.1,2024-04-24 07:30:00,66627.4,62.3,678396.3800000021,578396.3800000021
2024-04-24 07:45:00,66588.9,2024-04-24 22:15:00,64077.8,2511.1,680907.4800000021,580907.4800000021
2024-04-25 00:15:00,64449.1,2024-04-25 07:15:00,64218.1,-231.0,680676.4800000021,580676.4800000021
2024-04-25 07:30:00,63895.9,2024-04-25 15:15:00,63652.6,243.3,680919.7800000021,580919.7800000021
2024-04-25 15:30:00,63810.4,2024-04-25 23:00:00,64553.9,743.5,681663.2800000021,581663.2800000021
2024-04-25 23:15:00,64490.1,2024-04-26 05:30:00,64314.0,176.1,681839.3800000021,581839.3800000021
2024-04-26 05:45:00,64527.1,2024-04-26 12:45:00,64114.5,-603.48,681235.9000000021,581235.9000000021
2024-04-26 13:00:00,63900.0,2024-04-26 13:30:00,64072.1,-172.1,681063.8000000021,581063.8000000021
2024-04-26 13:45:00,64465.4,2024-04-26 14:30:00,64027.5,-437.9,680625.9000000021,580625.9000000021
2024-04-26 14:45:00,63827.1,2024-04-26 20:30:00,63898.8,-71.7,680554.2000000022,580554.2000000022
2024-04-26 20:45:00,63949.1,2024-04-27 00:00:00,63874.0,-75.1,680479.1000000022,580479.1000000022
2024-04-27 00:15:00,63499.9,2024-04-27 04:00:00,62930.1,569.8,681048.9000000022,581048.9000000022
2024-04-27 04:15:00,63102.0,2024-04-27 11:00:00,62820.0,-421.77,680627.1300000022,580627.1300000022
2024-04-27 16:15:00,62744.9,2024-04-27 17:30:00,63248.5,-576.21,680050.9200000023,580050.9200000023
2024-04-27 17:45:00,63381.1,2024-04-28 04:30:00,63887.0,505.9,680556.8200000023,580556.8200000023
2024-04-28 04:45:00,63813.0,2024-04-28 13:15:00,63671.2,141.8,680698.6200000023,580698.6200000023
2024-04-28 13:30:00,63770.3,2024-04-28 20:00:00,63607.6,-162.7,680535.9200000024,580535.9200000024
2024-04-28 20:15:00,63584.7,2024-04-29 09:30:00,62314.7,1270.0,681805.9200000024,581805.9200000024
2024-04-29 09:45:00,62508.6,2024-04-29 13:15:00,62483.7,-24.9,681781.0200000023,581781.0200000023
2024-04-29 13:30:00,61960.1,2024-04-29 14:00:00,62210.1,-250.0,681531.0200000023,581531.0200000023
2024-04-29 14:15:00,62789.9,2024-04-30 01:30:00,64084.1,1294.2,682825.2200000023,582825.2200000023
2024-04-30 01:45:00,63580.4,2024-04-30 11:30:00,61052.02,2528.38,685353.6000000023,585353.6000000023
2024-04-30 22:00:00,60400.0,2024-05-01 00:45:00,60217.2,-182.8,685170.8000000023,585170.8000000023
2024-05-01 01:00:00,59861.0,2024-05-01 11:30:00,57619.9,2241.1,687411.9000000022,587411.9000000022
2024-05-01 11:45:00,57862.1,2024-05-01 14:45:00,57461.5,-400.6,687011.3000000023,587011.3000000023
2024-05-01 15:00:00,56963.0,2024-05-01 18:00:00,57826.7,-863.7,686147.6000000023,586147.6000000023
2024-05-01 18:15:00,57970.8,2024-05-01 19:15:00,58040.3,69.5,686217.1000000023,586217.1000000023
2024-05-01 19:30:00,57496.2,2024-05-01 22:45:00,57857.9,-361.7,685855.4000000024,585855.4000000024
2024-05-01 23:00:00,58017.1,2024-05-02 01:15:00,57638.4,-378.7,685476.7000000024,585476.7000000024
2024-05-02 01:30:00,57158.1,2024-05-02 06:45:00,57600.7,-442.6,685034.1000000024,585034.1000000024
2024-05-02 07:00:00,57734.9,2024-05-03 00:00:00,59020.0,1285.1,686319.2000000024,586319.2000000024
2024-05-03 00:15:00,58851.8,2024-05-03 01:45:00,59284.8,-433.0,685886.2000000024,585886.2000000024
2024-05-03 02:00:00,59724.7,2024-05-03 06:00:00,59485.1,-239.6,685646.6000000024,585646.6000000024
2024-05-03 06:15:00,59391.5,2024-05-03 12:15:00,59136.0,255.5,685902.1000000024,585902.1000000024
2024-05-03 12:30:00,60424.0,2024-05-03 12:30:00,60424.0,-876.76,685025.3400000024,585025.3400000024
2024-05-04 02:30:00,62642.0,2024-05-04 05:30:00,63232.9,-590.9,684434.4400000024,584434.4400000024
2024-05-04 05:45:00,63358.8,2024-05-04 13:00:00,63892.6,533.8,684968.2400000024,584968.2400000024
2024-05-04 13:15:00,63717.0,2024-05-04 19:30:00,63669.1,47.9,685016.1400000025,585016.1400000025
2024-05-04 19:45:00,63885.2,2024-05-04 22:30:00,63683.7,-201.5,684814.6400000025,584814.6400000025
2024-05-04 22:45:00,63581.3,2024-05-05 00:15:00,63882.0,-567.92,684246.7200000024,584246.7200000024
2024-05-05 05:00:00,63430.6,2024-05-05 18:00:00,64019.5,588.9,684835.6200000024,584835.6200000024
2024-05-05 18:15:00,63953.4,2024-05-05 23:00:00,63915.7,37.7,684873.3200000024,584873.3200000024
2024-05-05 23:15:00,64156.4,2024-05-06 02:30:00,64068.3,-88.1,684785.2200000024,584785.2200000024
2024-05-06 02:45:00,63788.0,2024-05-06 05:00:00,64013.8,-225.8,684559.4200000024,584559.4200000024
2024-05-06 05:15:00,64252.1,2024-05-06 10:15:00,64786.7,534.6,685094.0200000023,585094.0200000023
2024-05-06 10:30:00,64111.2,2024-05-06 21:00:00,63470.3,640.9,685734.9200000024,585734.9200000024
2024-05-06 21:15:00,63517.9,2024-05-07 03:00:00,63595.7,77.8,685812.7200000024,585812.7200000024
2024-05-07 03:15:00,62937.5,2024-05-07 05:15:00,63330.0,-392.5,685420.2200000024,585420.2200000024
2024-05-07 05:30:00,63573.3,2024-05-07 11:15:00,64002.0,428.7,685848.9200000024,585848.9200000024
2024-05-07 11:30:00,63596.8,2024-05-07 14:30:00,63441.1,155.7,686004.6200000023,586004.6200000023
2024-05-07 14:45:00,63995.8,2024-05-07 16:45:00,63613.0,-382.8,685621.8200000023,585621.8200000023
2024-05-07 17:00:00,63470.0,2024-05-08 02:15:00,62711.0,759.0,686380.8200000023,586380.8200000023
2024-05-08 02:30:00,62773.3,2024-05-08 06:00:00,62513.9,-259.4,686121.4200000023,586121.4200000023
2024-05-08 06:15:00,62158.8,2024-05-08 14:15:00,62480.3,-321.5,685799.9200000023,585799.9200000023
2024-05-08 14:30:00,62702.9,2024-05-08 19:00:00,62259.6,-443.3,685356.6200000022,585356.6200000022
2024-05-08 19:15:00,62030.1,2024-05-09 01:30:00,61437.2,592.9,685949.5200000022,585949.5200000022
2024-05-09 01:45:00,61528.9,2024-05-09 07:30:00,61413.5,-115.4,685834.1200000022,585834.1200000022
2024-05-09 07:45:00,61222.5,2024-05-09 12:00:00,61189.9,32.6,685866.7200000022,585866.7200000022
2024-05-09 12:15:00,61200.0,2024-05-10 00:45:00,62818.4,1618.4,687485.1200000022,587485.1200000022
2024-05-10 01:00:00,62716.0,2024-05-10 07:00:00,63059.3,-572.53,686912.5900000022,586912.5900000022
2024-05-10 07:15:00,63244.5,2024-05-10 13:00:00,62959.5,-285.0,686627.5900000022,586627.5900000022
2024-05-10 13:15:00,62788.0,2024-05-10 22:45:00,60821.2,1966.8,688594.3900000022,588594.3900000022
2024-05-10 23:00:00,60924.0,2024-05-11 09:00:00,60794.4,-129.6,688464.7900000022,588464.7900000022
2024-05-11 09:15:00,60691.9,2024-05-11 12:45:00,60681.0,10.9,688475.6900000023,588475.6900000023
2024-05-11 13:00:00,60842.6,2024-05-11 19:15:00,61064.0,221.4,688697.0900000023,588697.0900000023
2024-05-11 19:30:00,61038.0,2024-05-12 04:30:00,60989.4,48.6,688745.6900000023,588745.6900000023
2024-05-12 04:45:00,61065.4,2024-05-12 07:00:00,60928.3,-137.1,688608.5900000023,588608.5900000023
2024-05-12 07:15:00,60781.1,2024-05-12 08:15:00,60887.6,-106.5,688502.0900000023,588502.0900000023
2024-05-12 08:30:00,61020.2,2024-05-12 16:30:00,61624.9,604.7,689106.7900000022,589106.7900000022
2024-05-12 16:45:00,61315.0,2024-05-12 22:00:00,61310.1,4.9,689111.6900000023,589111.6900000023
2024-05-12 22:15:00,61332.3,2024-05-13 01:15:00,61428.6,96.3,689207.9900000023,589207.9900000023
2024-05-13 01:30:00,61222.1,2024-05-13 06:15:00,61194.4,27.7,689235.6900000023,589235.6900000023
2024-05-13 06:30:00,61451.0,2024-05-13 18:00:00,62656.6,1205.6,690441.2900000022,590441.2900000022
2024-05-13 18:15:00,62639.9,2024-05-14 11:45:00,61770.2,869.7,691310.9900000022,591310.9900000022
2024-05-14 12:00:00,61990.0,2024-05-14 12:30:00,61765.1,-718.18,690592.8100000022,590592.8100000022
2024-05-14 16:30:00,61368.6,2024-05-14 21:15:00,61481.7,-113.1,690479.7100000022,590479.7100000022
2024-05-14 21:30:00,61730.7,2024-05-15 15:15:00,65045.21,3314.51,693794.2200000022,593794.2200000022
2024-05-16 02:30:00,65861.3,2024-05-16 07:15:00,66067.9,-206.6,693587.6200000022,593587.6200000022
2024-05-16 07:30:00,66118.3,2024-05-16 12:30:00,66058.0,-60.3,693527.3200000022,593527.3200000022
2024-05-16 12:45:00,65976.8,2024-05-16 19:00:00,65272.0,704.8,694232.1200000022,594232.1200000022
2024-05-16 19:15:00,65504.7,2024-05-17 17:45:00,66677.4,1172.7,695404.8200000022,595404.8200000022
2024-05-17 18:00:00,66385.2,2024-05-17 19:15:00,66865.5,-480.3,694924.5200000021,594924.5200000021
2024-05-17 19:30:00,66965.7,2024-05-18 06:00:00,66784.6,-181.1,694743.4200000021,594743.4200000021
2024-05-18 06:15:00,66730.9,2024-05-18 07:00:00,66874.5,-143.6,694599.8200000022,594599.8200000022
2024-05-18 07:15:00,67163.0,2024-05-18 13:30:00,66979.6,-183.4,694416.4200000021,594416.4200000021
2024-05-18 13:45:00,66831.4,2024-05-18 19:30:00,66835.2,-3.8,694412.6200000021,594412.6200000021
2024-05-18 19:45:00,66881.7,2024-05-19 06:15:00,67076.4,194.7,694607.320000002,594607.320000002
2024-05-19 06:30:00,66931.9,2024-05-19 07:30:00,67222.9,-344.42,694262.900000002,594262.900000002
2024-05-19 07:45:00,67295.0,2024-05-19 09:00:00,67050.0,-245.0,694017.900000002,594017.900000002
2024-05-19 09:15:00,66955.9,2024-05-19 10:15:00,67248.7,-292.8,693725.100000002,593725.100000002
2024-05-19 10:30:00,67544.8,2024-05-19 10:45:00,67246.9,-297.9,693427.2000000019,593427.2000000019
2024-05-19 11:00:00,67105.1,2024-05-20 00:15:00,66176.4,928.7,694355.9000000019,594355.9000000019
2024-05-20 00:30:00,66330.4,2024-05-20 06:30:00,66912.0,581.6,694937.5000000019,594937.5000000019
2024-05-20 06:45:00,66372.5,2024-05-20 07:45:00,66788.9,-416.4,694521.1000000018,594521.1000000018
2024-05-20 08:00:00,66879.2,2024-05-20 20:45:00,69490.0,2610.8,697131.9000000019,597131.9000000019
2024-05-20 21:00:00,69024.2,2024-05-20 22:45:00,69577.6,-553.4,696578.5000000019,596578.5000000019
2024-05-20 23:00:00,70060.1,2024-05-21 04:00:00,71175.1,1115.0,697693.5000000019,597693.5000000019
2024-05-21 04:15:00,71051.3,2024-05-21 22:00:00,69861.2,1190.1,698883.6000000018,598883.6000000018
2024-05-21 22:15:00,69979.6,2024-05-22 04:00:00,69855.0,-124.6,698759.0000000019,598759.0000000019
2024-05-22 04:15:00,69824.0,2024-05-22 05:15:00,69908.4,-84.4,698674.6000000018,598674.6000000018
2024-05-22 05:30:00,69935.9,2024-05-22 11:30:00,70054.2,118.3,698792.9000000019,598792.9000000019
2024-05-22 11:45:00,69770.3,2024-05-22 15:15:00,70252.0,-481.7,698311.2000000019,598311.2000000019
2024-05-22 15:30:00,70537.5,2024-05-22 17:45:00,69891.0,-646.5,697664.7000000019,597664.7000000019
2024-05-22 18:00:00,69728.3,2024-05-23 00:15:00,69400.1,328.2,697992.9000000019,597992.9000000019
2024-05-23 00:30:00,69586.7,2024-05-23 13:00:00,69434.7,-152.0,697840.9000000019,597840.9000000019
2024-05-23 13:15:00,69333.0,2024-05-23 20:00:00,66795.7,2537.3,700378.2000000019,600378.2000000019
2024-05-23 20:15:00,67529.9,2024-05-24 04:15:00,67763.2,233.3,700611.500000002,600611.500000002
2024-05-24 04:30:00,67702.4,2024-05-24 09:30:00,67331.9,370.5,700982.000000002,600982.000000002
2024-05-24 09:45:00,67397.8,2024-05-24 23:00:00,68757.1,1359.3,702341.300000002,602341.300000002
2024-05-24 23:15:00,68692.5,2024-05-25 07:45:00,68775.0,-82.5,702258.800000002,602258.800000002
2024-05-25 08:00:00,68850.0,2024-05-25 11:30:00,69419.4,569.4,702828.200000002,602828.200000002
2024-05-25 11:45:00,69112.5,2024-05-25 18:30:00,69143.2,-30.7,702797.5000000021,602797.5000000021
2024-05-25 18:45:00,69223.7,2024-05-26 01:45:00,69180.6,-43.1,702754.4000000021,602754.4000000021
2024-05-26 02:00:00,69130.7,2024-05-26 05:30:00,69072.0,58.7,702813.1000000021,602813.1000000021
2024-05-26 05:45:00,69161.0,2024-05-26 08:30:00,69213.8,52.8,702865.9000000021,602865.9000000021
2024-05-26 08:45:00,69182.2,2024-05-26 14:30:00,69180.3,1.9,702867.8000000021,602867.8000000021
2024-05-26 14:45:00,69303.9,2024-05-26 15:30:00,69124.4,-179.5,702688.3000000021,602688.3000000021
2024-05-26 15:45:00,68864.6,2024-05-26 21:45:00,68543.7,320.9,703009.2000000022,603009.2000000022
2024-05-26 22:00:00,68618.2,2024-05-27 03:45:00,68900.6,282.4,703291.6000000022,603291.6000000022
2024-05-27 04:00:00,68840.4,2024-05-27 08:00:00,68779.8,60.6,703352.2000000022,603352.2000000022
2024-05-27 08:15:00,68830.0,2024-05-27 10:00:00,68596.6,-233.4,703118.8000000021,603118.8000000021
2024-05-27 10:15:00,68487.0,2024-05-27 12:45:00,68654.8,-167.8,702951.0000000021,602951.0000000021
2024-05-27 13:00:00,68900.0,2024-05-27 18:15:00,70122.7,1222.7,704173.700000002,604173.700000002
2024-05-27 18:30:00,70061.2,2024-05-27 21:30:00,69735.4,325.8,704499.5000000021,604499.5000000021
2024-05-27 21:45:00,69835.7,2024-05-28 00:00:00,69440.1,-395.6,704103.9000000021,604103.9000000021
2024-05-28 00:15:00,69347.3,2024-05-28 08:30:00,68097.3,1250.0,705353.9000000021,605353.9000000021
2024-05-28 08:45:00,68174.0,2024-05-28 12:45:00,68232.9,58.9,705412.8000000021,605412.8000000021
2024-05-28 13:00:00,68202.4,2024-05-28 19:00:00,68269.8,-67.4,705345.4000000021,605345.4000000021
2024-05-28 19:15:00,68283.0,2024-05-29 06:45:00,68552.5,269.5,705614.9000000021,605614.9000000021
2024-05-29 07:00:00,68388.9,2024-05-29 22:00:00,67663.2,725.7,706340.6000000021,606340.6000000021
2024-05-29 22:15:00,67791.3,2024-05-30 05:45:00,68180.0,388.7,706729.300000002,606729.300000002
2024-05-30 06:00:00,67986.6,2024-05-30 10:15:00,67730.8,255.8,706985.1000000021,606985.1000000021
2024-05-30 10:30:00,67967.6,2024-05-30 19:30:00,68764.2,796.6,707781.700000002,607781.700000002
2024-05-30 19:45:00,68705.0,2024-05-31 00:45:00,68512.2,192.8,707974.5000000021,607974.5000000021
2024-05-31 01:00:00,68667.9,2024-05-31 06:30:00,68391.9,-276.0,707698.5000000021,607698.5000000021
2024-05-31 06:45:00,68313.6,2024-05-31 10:45:00,68371.1,-57.5,707641.0000000021,607641.0000000021
2024-05-31 11:00:00,68443.5,2024-05-31 13:30:00,68455.0,11.5,707652.5000000021,607652.5000000021
2024-05-31 13:45:00,68118.8,2024-05-31 18:15:00,67350.2,768.6,708421.1000000021,608421.1000000021
2024-05-31 18:30:00,67469.5,2024-05-31 22:30:00,67654.6,185.1,708606.200000002,608606.200000002
2024-05-31 22:45:00,67537.3,2024-06-01 02:15:00,67705.1,-167.8,708438.400000002,608438.400000002
2024-06-01 02:30:00,67723.7,2024-06-01 16:45:00,67740.0,16.3,708454.700000002,608454.700000002
2024-06-01 17:00:00,67685.3,2024-06-01 20:15:00,67783.2,-97.9,708356.800000002,608356.800000002
2024-06-01 20:30:00,67809.3,2024-06-02 05:30:00,67789.9,-19.4,708337.400000002,608337.400000002
2024-06-02 05:45:00,67746.3,2024-06-02 11:15:00,67662.7,83.6,708421.000000002,608421.000000002
2024-06-02 11:30:00,67746.7,2024-06-02 16:15:00,68096.8,350.1,708771.100000002,608771.100000002
2024-06-02 16:30:00,68073.5,2024-06-02 20:15:00,67727.9,345.6,709116.7000000019,609116.7000000019
2024-06-02 20:30:00,67802.9,2024-06-03 12:15:00,69484.95,1682.05,710798.750000002,610798.750000002
2024-06-03 14:30:00,69244.6,2024-06-03 15:30:00,69273.4,-28.8,710769.9500000019,610769.9500000019
2024-06-03 15:45:00,69650.0,2024-06-03 20:45:00,69150.2,-499.8,710270.1500000019,610270.1500000019
2024-06-03 21:00:00,69068.9,2024-06-04 01:30:00,69116.8,-47.9,710222.2500000019,610222.2500000019
2024-06-04 01:45:00,69259.9,2024-06-04 05:45:00,68995.4,-264.5,709957.7500000019,609957.7500000019
2024-06-04 06:00:00,68926.2,2024-06-04 12:00:00,69011.0,-84.8,709872.9500000018,609872.9500000018
2024-06-04 12:15:00,69095.6,2024-06-04 20:00:00,70350.1,1254.5,711127.4500000018,611127.4500000018
2024-06-04 20:15:00,70302.1,2024-06-05 00:30:00,70771.6,-601.01,710526.4400000018,610526.4400000018
2024-06-05 01:15:00,71047.2,2024-06-05 09:45:00,70947.9,-99.3,710427.1400000018,610427.1400000018
2024-06-05 10:00:00,70885.5,2024-06-05 15:00:00,70936.5,-51.0,710376.1400000018,610376.1400000018
2024-06-05 15:15:00,71599.9,2024-06-05 18:45:00,71134.5,-465.4,709910.7400000017,609910.7400000017
2024-06-05 19:00:00,70978.5,2024-06-06 01:45:00,71167.7,-189.2,709721.5400000018,609721.5400000018
2024-06-06 02:00:00,71240.1,2024-06-06 16:15:00,71091.2,-148.9,709572.6400000018,609572.6400000018
2024-06-06 16:30:00,70955.9,2024-06-06 20:30:00,70652.4,303.5,709876.1400000018,609876.1400000018
2024-06-06 20:45:00,70767.9,2024-06-07 12:30:00,71064.3,296.4,710172.5400000018,610172.5400000018
2024-06-07 12:45:00,71274.0,2024-06-07 20:45:00,69338.1,1935.9,712108.4400000018,612108.4400000018
2024-06-07 21:00:00,69391.4,2024-06-08 04:30:00,69382.6,-8.8,712099.6400000018,612099.6400000018
2024-06-08 04:45:00,69343.4,2024-06-08 07:00:00,69424.9,-81.5,712018.1400000018,612018.1400000018
2024-06-08 07:15:00,69525.6,2024-06-08 12:15:00,69391.6,-134.0,711884.1400000018,611884.1400000018
2024-06-08 12:30:00,69342.3,2024-06-08 14:30:00,69430.9,-88.6,711795.5400000018,611795.5400000018
2024-06-08 14:45:00,69499.9,2024-06-08 22:00:00,69425.5,-74.4,711721.1400000018,611721.1400000018
2024-06-08 22:15:00,69331.0,2024-06-09 04:00:00,69299.7,31.3,711752.4400000018,611752.4400000018
2024-06-09 04:15:00,69339.0,,,,,
